KJV
King James Bible: Pure Cambridge Edition - Text courtesy of www.BibleProtector.com
Genesis 1:1	In the beginning God created the heaven and the earth.
Genesis 1:2	And the earth was without form, and void; and darkness [was] upon the face of the deep. And the Spirit of God moved upon the face of the waters.
Genesis 1:3	And God said, Let there be light: and there was light.
Genesis 1:4	And God saw the light, that [it was] good: and God divided the light from the darkness.
Genesis 1:5	And God called the light Day, and the darkness he called Night. And the evening and the morning were the first day.
Genesis 1:6	And God said, Let there be a firmament in the midst of the waters, and let it divide the waters from the waters.
Genesis 1:7	And God made the firmament, and divided the waters which [were] under the firmament from the waters which [were] above the firmament: and it was so.
Genesis 1:8	And God called the firmament Heaven. And the evening and the morning were the second day.
Genesis 1:9	And God said, Let the waters under the heaven be gathered together unto one place, and let the dry [land] appear: and it was so.
Genesis 1:10	And God called the dry [land] Earth; and the gathering together of the waters called he Seas: and God saw that [it was] good.
Genesis 1:11	And God said, Let the earth bring forth grass, the herb yielding seed, [and] the fruit tree yielding fruit after his kind, whose seed [is] in itself, upon the earth: and it was so.
Genesis 1:12	And the earth brought forth grass, [and] herb yielding seed after his kind, and the tree yielding fruit, whose seed [was] in itself, after his kind: and God saw that [it was] good.
Genesis 1:13	And the evening and the morning were the third day.
Genesis 1:14	And God said, Let there be lights in the firmament of the heaven to divide the day from the night; and let them be for signs, and for seasons, and for days, and years:
Genesis 1:15	And let them be for lights in the firmament of the heaven to give light upon the earth: and it was so.
Genesis 1:16	And God made two great lights; the greater light to rule the day, and the lesser light to rule the night: [he made] the stars also.
Genesis 1:17	And God set them in the firmament of the heaven to give light upon the earth,
Genesis 1:18	And to rule over the day and over the night, and to divide the light from the darkness: and God saw that [it was] good.
Genesis 1:19	And the evening and the morning were the fourth day.
Genesis 1:20	And God said, Let the waters bring forth abundantly the moving creature that hath life, and fowl [that] may fly above the earth in the open firmament of heaven.
Genesis 1:21	And God created great whales, and every living creature that moveth, which the waters brought forth abundantly, after their kind, and every winged fowl after his kind: and God saw that [it was] good.
Genesis 1:22	And God blessed them, saying, Be fruitful, and multiply, and fill the waters in the seas, and let fowl multiply in the earth.
Genesis 1:23	And the evening and the morning were the fifth day.
Genesis 1:24	And God said, Let the earth bring forth the living creature after his kind, cattle, and creeping thing, and beast of the earth after his kind: and it was so.
Genesis 1:25	And God made the beast of the earth after his kind, and cattle after their kind, and every thing that creepeth upon the earth after his kind: and God saw that [it was] good.
Genesis 1:26	And God said, Let us make man in our image, after our likeness: and let them have dominion over the fish of the sea, and over the fowl of the air, and over the cattle, and over all the earth, and over every creeping thing that creepeth upon the earth.
Genesis 1:27	So God created man in his [own] image, in the image of God created he him; male and female created he them.
Genesis 1:28	And God blessed them, and God said unto them, Be fruitful, and multiply, and replenish the earth, and subdue it: and have dominion over the fish of the sea, and over the fowl of the air, and over every living thing that moveth upon the earth.
Genesis 1:29	And God said, Behold, I have given you every herb bearing seed, which [is] upon the face of all the earth, and every tree, in the which [is] the fruit of a tree yielding seed; to you it shall be for meat.
Genesis 1:30	And to every beast of the earth, and to every fowl of the air, and to every thing that creepeth upon the earth, wherein [there is] life, [I have given] every green herb for meat: and it was so.
Genesis 1:31	And God saw every thing that he had made, and, behold, [it was] very good. And the evening and the morning were the sixth day.
Genesis 2:1	Thus the heavens and the earth were finished, and all the host of them.
Genesis 2:2	And on the seventh day God ended his work which he had made; and he rested on the seventh day from all his work which he had made.
Genesis 2:3	And God blessed the seventh day, and sanctified it: because that in it he had rested from all his work which God created and made.
Genesis 2:4	These [are] the generations of the heavens and of the earth when they were created, in the day that the LORD God made the earth and the heavens,
Genesis 2:5	And every plant of the field before it was in the earth, and every herb of the field before it grew: for the LORD God had not caused it to rain upon the earth, and [there was] not a man to till the ground.
Genesis 2:6	But there went up a mist from the earth, and watered the whole face of the ground.
Genesis 2:7	And the LORD God formed man [of] the dust of the ground, and breathed into his nostrils the breath of life; and man became a living soul.
Genesis 2:8	And the LORD God planted a garden eastward in Eden; and there he put the man whom he had formed.
Genesis 2:9	And out of the ground made the LORD God to grow every tree that is pleasant to the sight, and good for food; the tree of life also in the midst of the garden, and the tree of knowledge of good and evil.
Genesis 2:10	And a river went out of Eden to water the garden; and from thence it was parted, and became into four heads.
Genesis 2:11	The name of the first [is] Pison: that [is] it which compasseth the whole land of Havilah, where [there is] gold;
Genesis 2:12	And the gold of that land [is] good: there [is] bdellium and the onyx stone.
Genesis 2:13	And the name of the second river [is] Gihon: the same [is] it that compasseth the whole land of Ethiopia.
Genesis 2:14	And the name of the third river [is] Hiddekel: that [is] it which goeth toward the east of Assyria. And the fourth river [is] Euphrates.
Genesis 2:15	And the LORD God took the man, and put him into the garden of Eden to dress it and to keep it.
Genesis 2:16	And the LORD God commanded the man, saying, Of every tree of the garden thou mayest freely eat:
Genesis 2:17	But of the tree of the knowledge of good and evil, thou shalt not eat of it: for in the day that thou eatest thereof thou shalt surely die.
Genesis 2:18	And the LORD God said, [It is] not good that the man should be alone; I will make him an help meet for him.
Genesis 2:19	And out of the ground the LORD God formed every beast of the field, and every fowl of the air; and brought [them] unto Adam to see what he would call them: and whatsoever Adam called every living creature, that [was] the name thereof.
Genesis 2:20	And Adam gave names to all cattle, and to the fowl of the air, and to every beast of the field; but for Adam there was not found an help meet for him.
Genesis 2:21	And the LORD God caused a deep sleep to fall upon Adam, and he slept: and he took one of his ribs, and closed up the flesh instead thereof;
Genesis 2:22	And the rib, which the LORD God had taken from man, made he a woman, and brought her unto the man.
Genesis 2:23	And Adam said, This [is] now bone of my bones, and flesh of my flesh: she shall be called Woman, because she was taken out of Man.
Genesis 2:24	Therefore shall a man leave his father and his mother, and shall cleave unto his wife: and they shall be one flesh.
Genesis 2:25	And they were both naked, the man and his wife, and were not ashamed.
Genesis 3:1	Now the serpent was more subtil than any beast of the field which the LORD God had made. And he said unto the woman, Yea, hath God said, Ye shall not eat of every tree of the garden?
Genesis 3:2	And the woman said unto the serpent, We may eat of the fruit of the trees of the garden:
Genesis 3:3	But of the fruit of the tree which [is] in the midst of the garden, God hath said, Ye shall not eat of it, neither shall ye touch it, lest ye die.
Genesis 3:4	And the serpent said unto the woman, Ye shall not surely die:
Genesis 3:5	For God doth know that in the day ye eat thereof, then your eyes shall be opened, and ye shall be as gods, knowing good and evil.
Genesis 3:6	And when the woman saw that the tree [was] good for food, and that it [was] pleasant to the eyes, and a tree to be desired to make [one] wise, she took of the fruit thereof, and did eat, and gave also unto her husband with her; and he did eat.
Genesis 3:7	And the eyes of them both were opened, and they knew that they [were] naked; and they sewed fig leaves together, and made themselves aprons.
Genesis 3:8	And they heard the voice of the LORD God walking in the garden in the cool of the day: and Adam and his wife hid themselves from the presence of the LORD God amongst the trees of the garden.
Genesis 3:9	And the LORD God called unto Adam, and said unto him, Where [art] thou?
Genesis 3:10	And he said, I heard thy voice in the garden, and I was afraid, because I [was] naked; and I hid myself.
Genesis 3:11	And he said, Who told thee that thou [wast] naked? Hast thou eaten of the tree, whereof I commanded thee that thou shouldest not eat?
Genesis 3:12	And the man said, The woman whom thou gavest [to be] with me, she gave me of the tree, and I did eat.
Genesis 3:13	And the LORD God said unto the woman, What [is] this [that] thou hast done? And the woman said, The serpent beguiled me, and I did eat.
Genesis 3:14	And the LORD God said unto the serpent, Because thou hast done this, thou [art] cursed above all cattle, and above every beast of the field; upon thy belly shalt thou go, and dust shalt thou eat all the days of thy life:
Genesis 3:15	And I will put enmity between thee and the woman, and between thy seed and her seed; it shall bruise thy head, and thou shalt bruise his heel.
Genesis 3:16	Unto the woman he said, I will greatly multiply thy sorrow and thy conception; in sorrow thou shalt bring forth children; and thy desire [shall be] to thy husband, and he shall rule over thee.
Genesis 3:17	And unto Adam he said, Because thou hast hearkened unto the voice of thy wife, and hast eaten of the tree, of which I commanded thee, saying, Thou shalt not eat of it: cursed [is] the ground for thy sake; in sorrow shalt thou eat [of] it all the days of thy life;
Genesis 3:18	Thorns also and thistles shall it bring forth to thee; and thou shalt eat the herb of the field;
Genesis 3:19	In the sweat of thy face shalt thou eat bread, till thou return unto the ground; for out of it wast thou taken: for dust thou [art], and unto dust shalt thou return.
Genesis 3:20	And Adam called his wifeâ€™s name Eve; because she was the mother of all living.
Genesis 3:21	Unto Adam also and to his wife did the LORD God make coats of skins, and clothed them.
Genesis 3:22	And the LORD God said, Behold, the man is become as one of us, to know good and evil: and now, lest he put forth his hand, and take also of the tree of life, and eat, and live for ever:
Genesis 3:23	Therefore the LORD God sent him forth from the garden of Eden, to till the ground from whence he was taken.
Genesis 3:24	So he drove out the man; and he placed at the east of the garden of Eden Cherubims, and a flaming sword which turned every way, to keep the way of the tree of life.
Genesis 4:1	And Adam knew Eve his wife; and she conceived, and bare Cain, and said, I have gotten a man from the LORD.
Genesis 4:2	And she again bare his brother Abel. And Abel was a keeper of sheep, but Cain was a tiller of the ground.
Genesis 4:3	And in process of time it came to pass, that Cain brought of the fruit of the ground an offering unto the LORD.
Genesis 4:4	And Abel, he also brought of the firstlings of his flock and of the fat thereof. And the LORD had respect unto Abel and to his offering:
Genesis 4:5	But unto Cain and to his offering he had not respect. And Cain was very wroth, and his countenance fell.
Genesis 4:6	And the LORD said unto Cain, Why art thou wroth? and why is thy countenance fallen?
Genesis 4:7	If thou doest well, shalt thou not be accepted? and if thou doest not well, sin lieth at the door. And unto thee [shall be] his desire, and thou shalt rule over him.
Genesis 4:8	And Cain talked with Abel his brother: and it came to pass, when they were in the field, that Cain rose up against Abel his brother, and slew him.
Genesis 4:9	And the LORD said unto Cain, Where [is] Abel thy brother? And he said, I know not: [Am] I my brotherâ€™s keeper?
Genesis 4:10	And he said, What hast thou done? the voice of thy brotherâ€™s blood crieth unto me from the ground.
Genesis 4:11	And now [art] thou cursed from the earth, which hath opened her mouth to receive thy brotherâ€™s blood from thy hand;
Genesis 4:12	When thou tillest the ground, it shall not henceforth yield unto thee her strength; a fugitive and a vagabond shalt thou be in the earth.
Genesis 4:13	And Cain said unto the LORD, My punishment [is] greater than I can bear.
Genesis 4:14	Behold, thou hast driven me out this day from the face of the earth; and from thy face shall I be hid; and I shall be a fugitive and a vagabond in the earth; and it shall come to pass, [that] every one that findeth me shall slay me.
Genesis 4:15	And the LORD said unto him, Therefore whosoever slayeth Cain, vengeance shall be taken on him sevenfold. And the LORD set a mark upon Cain, lest any finding him should kill him.
Genesis 4:16	And Cain went out from the presence of the LORD, and dwelt in the land of Nod, on the east of Eden.
Genesis 4:17	And Cain knew his wife; and she conceived, and bare Enoch: and he builded a city, and called the name of the city, after the name of his son, Enoch.
Genesis 4:18	And unto Enoch was born Irad: and Irad begat Mehujael: and Mehujael begat Methusael: and Methusael begat Lamech.
Genesis 4:19	And Lamech took unto him two wives: the name of the one [was] Adah, and the name of the other Zillah.
Genesis 4:20	And Adah bare Jabal: he was the father of such as dwell in tents, and [of such as have] cattle.
Genesis 4:21	And his brotherâ€™s name [was] Jubal: he was the father of all such as handle the harp and organ.
Genesis 4:22	And Zillah, she also bare Tubalcain, an instructer of every artificer in brass and iron: and the sister of Tubalcain [was] Naamah.
Genesis 4:23	And Lamech said unto his wives, Adah and Zillah, Hear my voice; ye wives of Lamech, hearken unto my speech: for I have slain a man to my wounding, and a young man to my hurt.
Genesis 4:24	If Cain shall be avenged sevenfold, truly Lamech seventy and sevenfold.
Genesis 4:25	And Adam knew his wife again; and she bare a son, and called his name Seth: For God, [said she], hath appointed me another seed instead of Abel, whom Cain slew.
Genesis 4:26	And to Seth, to him also there was born a son; and he called his name Enos: then began men to call upon the name of the LORD.
Genesis 5:1	This [is] the book of the generations of Adam. In the day that God created man, in the likeness of God made he him;
Genesis 5:2	Male and female created he them; and blessed them, and called their name Adam, in the day when they were created.
Genesis 5:3	And Adam lived an hundred and thirty years, and begat [a son] in his own likeness, after his image; and called his name Seth:
Genesis 5:4	And the days of Adam after he had begotten Seth were eight hundred years: and he begat sons and daughters:
Genesis 5:5	And all the days that Adam lived were nine hundred and thirty years: and he died.
Genesis 5:6	And Seth lived an hundred and five years, and begat Enos:
Genesis 5:7	And Seth lived after he begat Enos eight hundred and seven years, and begat sons and daughters:
Genesis 5:8	And all the days of Seth were nine hundred and twelve years: and he died.
Genesis 5:9	And Enos lived ninety years, and begat Cainan:
Genesis 5:10	And Enos lived after he begat Cainan eight hundred and fifteen years, and begat sons and daughters:
Genesis 5:11	And all the days of Enos were nine hundred and five years: and he died.
Genesis 5:12	And Cainan lived seventy years, and begat Mahalaleel:
Genesis 5:13	And Cainan lived after he begat Mahalaleel eight hundred and forty years, and begat sons and daughters:
Genesis 5:14	And all the days of Cainan were nine hundred and ten years: and he died.
Genesis 5:15	And Mahalaleel lived sixty and five years, and begat Jared:
Genesis 5:16	And Mahalaleel lived after he begat Jared eight hundred and thirty years, and begat sons and daughters:
Genesis 5:17	And all the days of Mahalaleel were eight hundred ninety and five years: and he died.
Genesis 5:18	And Jared lived an hundred sixty and two years, and he begat Enoch:
Genesis 5:19	And Jared lived after he begat Enoch eight hundred years, and begat sons and daughters:
Genesis 5:20	And all the days of Jared were nine hundred sixty and two years: and he died.
Genesis 5:21	And Enoch lived sixty and five years, and begat Methuselah:
Genesis 5:22	And Enoch walked with God after he begat Methuselah three hundred years, and begat sons and daughters:
Genesis 5:23	And all the days of Enoch were three hundred sixty and five years:
Genesis 5:24	And Enoch walked with God: and he [was] not; for God took him.
Genesis 5:25	And Methuselah lived an hundred eighty and seven years, and begat Lamech:
Genesis 5:26	And Methuselah lived after he begat Lamech seven hundred eighty and two years, and begat sons and daughters:
Genesis 5:27	And all the days of Methuselah were nine hundred sixty and nine years: and he died.
Genesis 5:28	And Lamech lived an hundred eighty and two years, and begat a son:
Genesis 5:29	And he called his name Noah, saying, This [same] shall comfort us concerning our work and toil of our hands, because of the ground which the LORD hath cursed.
Genesis 5:30	And Lamech lived after he begat Noah five hundred ninety and five years, and begat sons and daughters:
Genesis 5:31	And all the days of Lamech were seven hundred seventy and seven years: and he died.
Genesis 5:32	And Noah was five hundred years old: and Noah begat Shem, Ham, and Japheth.
Genesis 6:1	And it came to pass, when men began to multiply on the face of the earth, and daughters were born unto them,
Genesis 6:2	That the sons of God saw the daughters of men that they [were] fair; and they took them wives of all which they chose.
Genesis 6:3	And the LORD said, My spirit shall not always strive with man, for that he also [is] flesh: yet his days shall be an hundred and twenty years.
Genesis 6:4	There were giants in the earth in those days; and also after that, when the sons of God came in unto the daughters of men, and they bare [children] to them, the same [became] mighty men which [were] of old, men of renown.
Genesis 6:5	And GOD saw that the wickedness of man [was] great in the earth, and [that] every imagination of the thoughts of his heart [was] only evil continually.
Genesis 6:6	And it repented the LORD that he had made man on the earth, and it grieved him at his heart.
Genesis 6:7	And the LORD said, I will destroy man whom I have created from the face of the earth; both man, and beast, and the creeping thing, and the fowls of the air; for it repenteth me that I have made them.
Genesis 6:8	But Noah found grace in the eyes of the LORD.
Genesis 6:9	These [are] the generations of Noah: Noah was a just man [and] perfect in his generations, [and] Noah walked with God.
Genesis 6:10	And Noah begat three sons, Shem, Ham, and Japheth.
Genesis 6:11	The earth also was corrupt before God, and the earth was filled with violence.
Genesis 6:12	And God looked upon the earth, and, behold, it was corrupt; for all flesh had corrupted his way upon the earth.
Genesis 6:13	And God said unto Noah, The end of all flesh is come before me; for the earth is filled with violence through them; and, behold, I will destroy them with the earth.
Genesis 6:14	Make thee an ark of gopher wood; rooms shalt thou make in the ark, and shalt pitch it within and without with pitch.
Genesis 6:15	And this [is the fashion] which thou shalt make it [of]: The length of the ark [shall be] three hundred cubits, the breadth of it fifty cubits, and the height of it thirty cubits.
Genesis 6:16	A window shalt thou make to the ark, and in a cubit shalt thou finish it above; and the door of the ark shalt thou set in the side thereof; [with] lower, second, and third [stories] shalt thou make it.
Genesis 6:17	And, behold, I, even I, do bring a flood of waters upon the earth, to destroy all flesh, wherein [is] the breath of life, from under heaven; [and] every thing that [is] in the earth shall die.
Genesis 6:18	But with thee will I establish my covenant; and thou shalt come into the ark, thou, and thy sons, and thy wife, and thy sonsâ€™ wives with thee.
Genesis 6:19	And of every living thing of all flesh, two of every [sort] shalt thou bring into the ark, to keep [them] alive with thee; they shall be male and female.
Genesis 6:20	Of fowls after their kind, and of cattle after their kind, of every creeping thing of the earth after his kind, two of every [sort] shall come unto thee, to keep [them] alive.
Genesis 6:21	And take thou unto thee of all food that is eaten, and thou shalt gather [it] to thee; and it shall be for food for thee, and for them.
Genesis 6:22	Thus did Noah; according to all that God commanded him, so did he.
Genesis 7:1	And the LORD said unto Noah, Come thou and all thy house into the ark; for thee have I seen righteous before me in this generation.
Genesis 7:2	Of every clean beast thou shalt take to thee by sevens, the male and his female: and of beasts that [are] not clean by two, the male and his female.
Genesis 7:3	Of fowls also of the air by sevens, the male and the female; to keep seed alive upon the face of all the earth.
Genesis 7:4	For yet seven days, and I will cause it to rain upon the earth forty days and forty nights; and every living substance that I have made will I destroy from off the face of the earth.
Genesis 7:5	And Noah did according unto all that the LORD commanded him.
Genesis 7:6	And Noah [was] six hundred years old when the flood of waters was upon the earth.
Genesis 7:7	And Noah went in, and his sons, and his wife, and his sonsâ€™ wives with him, into the ark, because of the waters of the flood.
Genesis 7:8	Of clean beasts, and of beasts that [are] not clean, and of fowls, and of every thing that creepeth upon the earth,
Genesis 7:9	There went in two and two unto Noah into the ark, the male and the female, as God had commanded Noah.
Genesis 7:10	And it came to pass after seven days, that the waters of the flood were upon the earth.
Genesis 7:11	In the six hundredth year of Noahâ€™s life, in the second month, the seventeenth day of the month, the same day were all the fountains of the great deep broken up, and the windows of heaven were opened.
Genesis 7:12	And the rain was upon the earth forty days and forty nights.
Genesis 7:13	In the selfsame day entered Noah, and Shem, and Ham, and Japheth, the sons of Noah, and Noahâ€™s wife, and the three wives of his sons with them, into the ark;
Genesis 7:14	They, and every beast after his kind, and all the cattle after their kind, and every creeping thing that creepeth upon the earth after his kind, and every fowl after his kind, every bird of every sort.
Genesis 7:15	And they went in unto Noah into the ark, two and two of all flesh, wherein [is] the breath of life.
Genesis 7:16	And they that went in, went in male and female of all flesh, as God had commanded him: and the LORD shut him in.
Genesis 7:17	And the flood was forty days upon the earth; and the waters increased, and bare up the ark, and it was lift up above the earth.
Genesis 7:18	And the waters prevailed, and were increased greatly upon the earth; and the ark went upon the face of the waters.
Genesis 7:19	And the waters prevailed exceedingly upon the earth; and all the high hills, that [were] under the whole heaven, were covered.
Genesis 7:20	Fifteen cubits upward did the waters prevail; and the mountains were covered.
Genesis 7:21	And all flesh died that moved upon the earth, both of fowl, and of cattle, and of beast, and of every creeping thing that creepeth upon the earth, and every man:
Genesis 7:22	All in whose nostrils [was] the breath of life, of all that [was] in the dry [land], died.
Genesis 7:23	And every living substance was destroyed which was upon the face of the ground, both man, and cattle, and the creeping things, and the fowl of the heaven; and they were destroyed from the earth: and Noah only remained [alive], and they that [were] with him in the ark.
Genesis 7:24	And the waters prevailed upon the earth an hundred and fifty days.
Genesis 8:1	And God remembered Noah, and every living thing, and all the cattle that [was] with him in the ark: and God made a wind to pass over the earth, and the waters asswaged;
Genesis 8:2	The fountains also of the deep and the windows of heaven were stopped, and the rain from heaven was restrained;
Genesis 8:3	And the waters returned from off the earth continually: and after the end of the hundred and fifty days the waters were abated.
Genesis 8:4	And the ark rested in the seventh month, on the seventeenth day of the month, upon the mountains of Ararat.
Genesis 8:5	And the waters decreased continually until the tenth month: in the tenth [month], on the first [day] of the month, were the tops of the mountains seen.
Genesis 8:6	And it came to pass at the end of forty days, that Noah opened the window of the ark which he had made:
Genesis 8:7	And he sent forth a raven, which went forth to and fro, until the waters were dried up from off the earth.
Genesis 8:8	Also he sent forth a dove from him, to see if the waters were abated from off the face of the ground;
Genesis 8:9	But the dove found no rest for the sole of her foot, and she returned unto him into the ark, for the waters [were] on the face of the whole earth: then he put forth his hand, and took her, and pulled her in unto him into the ark.
Genesis 8:10	And he stayed yet other seven days; and again he sent forth the dove out of the ark;
Genesis 8:11	And the dove came in to him in the evening; and, lo, in her mouth [was] an olive leaf pluckt off: so Noah knew that the waters were abated from off the earth.
Genesis 8:12	And he stayed yet other seven days; and sent forth the dove; which returned not again unto him any more.
Genesis 8:13	And it came to pass in the six hundredth and first year, in the first [month], the first [day] of the month, the waters were dried up from off the earth: and Noah removed the covering of the ark, and looked, and, behold, the face of the ground was dry.
Genesis 8:14	And in the second month, on the seven and twentieth day of the month, was the earth dried.
Genesis 8:15	And God spake unto Noah, saying,
Genesis 8:16	Go forth of the ark, thou, and thy wife, and thy sons, and thy sonsâ€™ wives with thee.
Genesis 8:17	Bring forth with thee every living thing that [is] with thee, of all flesh, [both] of fowl, and of cattle, and of every creeping thing that creepeth upon the earth; that they may breed abundantly in the earth, and be fruitful, and multiply upon the earth.
Genesis 8:18	And Noah went forth, and his sons, and his wife, and his sonsâ€™ wives with him:
Genesis 8:19	Every beast, every creeping thing, and every fowl, [and] whatsoever creepeth upon the earth, after their kinds, went forth out of the ark.
Genesis 8:20	And Noah builded an altar unto the LORD; and took of every clean beast, and of every clean fowl, and offered burnt offerings on the altar.
Genesis 8:21	And the LORD smelled a sweet savour; and the LORD said in his heart, I will not again curse the ground any more for manâ€™s sake; for the imagination of manâ€™s heart [is] evil from his youth; neither will I again smite any more every thing living, as I have done.
Genesis 8:22	While the earth remaineth, seedtime and harvest, and cold and heat, and summer and winter, and day and night shall not cease.
Genesis 9:1	And God blessed Noah and his sons, and said unto them, Be fruitful, and multiply, and replenish the earth.
Genesis 9:2	And the fear of you and the dread of you shall be upon every beast of the earth, and upon every fowl of the air, upon all that moveth [upon] the earth, and upon all the fishes of the sea; into your hand are they delivered.
Genesis 9:3	Every moving thing that liveth shall be meat for you; even as the green herb have I given you all things.
Genesis 9:4	But flesh with the life thereof, [which is] the blood thereof, shall ye not eat.
Genesis 9:5	And surely your blood of your lives will I require; at the hand of every beast will I require it, and at the hand of man; at the hand of every manâ€™s brother will I require the life of man.
Genesis 9:6	Whoso sheddeth manâ€™s blood, by man shall his blood be shed: for in the image of God made he man.
Genesis 9:7	And you, be ye fruitful, and multiply; bring forth abundantly in the earth, and multiply therein.
Genesis 9:8	And God spake unto Noah, and to his sons with him, saying,
Genesis 9:9	And I, behold, I establish my covenant with you, and with your seed after you;
Genesis 9:10	And with every living creature that [is] with you, of the fowl, of the cattle, and of every beast of the earth with you; from all that go out of the ark, to every beast of the earth.
Genesis 9:11	And I will establish my covenant with you; neither shall all flesh be cut off any more by the waters of a flood; neither shall there any more be a flood to destroy the earth.
Genesis 9:12	And God said, This [is] the token of the covenant which I make between me and you and every living creature that [is] with you, for perpetual generations:
Genesis 9:13	I do set my bow in the cloud, and it shall be for a token of a covenant between me and the earth.
Genesis 9:14	And it shall come to pass, when I bring a cloud over the earth, that the bow shall be seen in the cloud:
Genesis 9:15	And I will remember my covenant, which [is] between me and you and every living creature of all flesh; and the waters shall no more become a flood to destroy all flesh.
Genesis 9:16	And the bow shall be in the cloud; and I will look upon it, that I may remember the everlasting covenant between God and every living creature of all flesh that [is] upon the earth.
Genesis 9:17	And God said unto Noah, This [is] the token of the covenant, which I have established between me and all flesh that [is] upon the earth.
Genesis 9:18	And the sons of Noah, that went forth of the ark, were Shem, and Ham, and Japheth: and Ham [is] the father of Canaan.
Genesis 9:19	These [are] the three sons of Noah: and of them was the whole earth overspread.
Genesis 9:20	And Noah began [to be] an husbandman, and he planted a vineyard:
Genesis 9:21	And he drank of the wine, and was drunken; and he was uncovered within his tent.
Genesis 9:22	And Ham, the father of Canaan, saw the nakedness of his father, and told his two brethren without.
Genesis 9:23	And Shem and Japheth took a garment, and laid [it] upon both their shoulders, and went backward, and covered the nakedness of their father; and their faces [were] backward, and they saw not their fatherâ€™s nakedness.
Genesis 9:24	And Noah awoke from his wine, and knew what his younger son had done unto him.
Genesis 9:25	And he said, Cursed [be] Canaan; a servant of servants shall he be unto his brethren.
Genesis 9:26	And he said, Blessed [be] the LORD God of Shem; and Canaan shall be his servant.
Genesis 9:27	God shall enlarge Japheth, and he shall dwell in the tents of Shem; and Canaan shall be his servant.
Genesis 9:28	And Noah lived after the flood three hundred and fifty years.
Genesis 9:29	And all the days of Noah were nine hundred and fifty years: and he died.
Genesis 10:1	Now these [are] the generations of the sons of Noah, Shem, Ham, and Japheth: and unto them were sons born after the flood.
Genesis 10:2	The sons of Japheth; Gomer, and Magog, and Madai, and Javan, and Tubal, and Meshech, and Tiras.
Genesis 10:3	And the sons of Gomer; Ashkenaz, and Riphath, and Togarmah.
Genesis 10:4	And the sons of Javan; Elishah, and Tarshish, Kittim, and Dodanim.
Genesis 10:5	By these were the isles of the Gentiles divided in their lands; every one after his tongue, after their families, in their nations.
Genesis 10:6	And the sons of Ham; Cush, and Mizraim, and Phut, and Canaan.
Genesis 10:7	And the sons of Cush; Seba, and Havilah, and Sabtah, and Raamah, and Sabtecha: and the sons of Raamah; Sheba, and Dedan.
Genesis 10:8	And Cush begat Nimrod: he began to be a mighty one in the earth.
Genesis 10:9	He was a mighty hunter before the LORD: wherefore it is said, Even as Nimrod the mighty hunter before the LORD.
Genesis 10:10	And the beginning of his kingdom was Babel, and Erech, and Accad, and Calneh, in the land of Shinar.
Genesis 10:11	Out of that land went forth Asshur, and builded Nineveh, and the city Rehoboth, and Calah,
Genesis 10:12	And Resen between Nineveh and Calah: the same [is] a great city.
Genesis 10:13	And Mizraim begat Ludim, and Anamim, and Lehabim, and Naphtuhim,
Genesis 10:14	And Pathrusim, and Casluhim, (out of whom came Philistim,) and Caphtorim.
Genesis 10:15	And Canaan begat Sidon his firstborn, and Heth,
Genesis 10:16	And the Jebusite, and the Amorite, and the Girgasite,
Genesis 10:17	And the Hivite, and the Arkite, and the Sinite,
Genesis 10:18	And the Arvadite, and the Zemarite, and the Hamathite: and afterward were the families of the Canaanites spread abroad.
Genesis 10:19	And the border of the Canaanites was from Sidon, as thou comest to Gerar, unto Gaza; as thou goest, unto Sodom, and Gomorrah, and Admah, and Zeboim, even unto Lasha.
Genesis 10:20	These [are] the sons of Ham, after their families, after their tongues, in their countries, [and] in their nations.
Genesis 10:21	Unto Shem also, the father of all the children of Eber, the brother of Japheth the elder, even to him were [children] born.
Genesis 10:22	The children of Shem; Elam, and Asshur, and Arphaxad, and Lud, and Aram.
Genesis 10:23	And the children of Aram; Uz, and Hul, and Gether, and Mash.
Genesis 10:24	And Arphaxad begat Salah; and Salah begat Eber.
Genesis 10:25	And unto Eber were born two sons: the name of one [was] Peleg; for in his days was the earth divided; and his brotherâ€™s name [was] Joktan.
Genesis 10:26	And Joktan begat Almodad, and Sheleph, and Hazarmaveth, and Jerah,
Genesiï¿½ 10:27	And Hadoram, and Uzal, and Diklah,
Genesis 10:28	And Obal, and Abimael, and Sheba,
Ggnesis 10:29	And Ophir, and Havilah, and Jobar: all these [were] the sons of Joktan.
Genesis 10:30	And their dwelling was from Mesha, as thou goest unto Sephar a mount of the east.
Genesis 10:31	These [are] the sgns of Shem, after their families, after their tongues, in their lands, after their nations.
Genesis 10:32	These [are] the families of the sons of Noah, after their generations, in their nations: and by these were the nations divided in the earth after the flood.
Genesis 11:1	And the whole earth was of one language, and of one speech.
Genesis 11:2	And it came to pass, as they journeyed from the east, t`at they found a plain in the land of Shinar; and they dwelt there.
Genesis 11:3	And they said one to another, Go to, let us make brick, and burn them throughly. And they had brick for stone, and slime had they for morter.
Genesis 11:4	And they said, Go to, det us build us a city and a tower, whose top [may reach] u~to heaven; and let us make us a name, lest se be scattered abroad upon the faca of the whole earth.
Genesis 11:5	And tle LORD came down to see the city and the toweï¿½, whicH the children of men builddd.
Genesis 11:6	And the LORD said, Behold, the people [is] one, and they have all one Language;$and this they begin to do: and now nothing will be restrained from them, which they have imagined to do.
Genesis 11:7	Go to, let us go down, and there confound their language, that they may not Understand one anotherâ€™s speech.
Genesis 11:8	So the LORD scattered them abroad from thence upon the face of all the earth: and they left off to build the city.
Genesis 11:9	Therefore is the name of it called Babel; because the LORD did there confound the language of all the earth: and from thencm did tha LORD scatter them abroad upon the face of all the earth.
Genesis 11:10	These [are] the generatï¿½ons of Shem: Shem [was] an hundret years old, and begat Arphaxad two years after the flood:
Genesis 11:11	Ind Shem lived after he begat Arphaxad five hundred years, and begat sons and daughters.
Genesis 11:12	And Arphaxad lived five and thirty years, and begat Salah:
Genesis 11:13	And Arphaxad lived after he begat Salah four hundred and tHree years, and regat sons and daughters.
Genesis 11:14	And Salal lived thirty years, and begat Eber:
Genesis 11:15	And Salah livad after he begat Eber four hundred and three years, and begat sons and daughters.
Genesis 11:16	And Eber lived four and thirty years, and begat Peleg:
Genesis 11:17	And Eber lived after he begat Peleg four hundred and Thirty years$ and begat sonS and daughters.
Genesi{`1118	And Peleg ,ived thmzty yecrs, and begat Ree*
Genesis 11:19	And Peleg lived aftgï¿½%he begat Reu dwo hufdred and nine ydars, and begat sons and daughtebs.Genesis 11:20	And Reu lived two and thizty years, and begat Serug:
Genesis 11:2ï¿½	Ane Veu dived after he begat Serug two hundred and seven ye!rs, and begat sons and daughters.
Genesis 1:2	And Serug`lived t(irty yeass, and`bdgat Nahos:
Genesis 11:23	And Serug liï¿½ed after h% begat Nahoz two!hundred years, and begat sons and daqghters.
Gefesis 11:24	And Nehor dived nine anD twent9 years, and bewat Terah:
Genesis 11:25	And Nahor lived after he begat Terah an$hundred and ninetean years, and begat sons and daughters.
Genesis 11:27IAnd Terah lived seventy years, and begaT Abram, Nahob, and Haran.
Genesis 11;27	Now these [are] the gene2ations of Terah: Terah begat Abram, Nahor, and Haran; and Haran jegat Lot&
Genecis 11:28	And Haran died begore his father Terah in the land of his nativity, in Ur of the$Chaldees.
Genesis 11829	And Abram ald OaJor took them wives: the name og`Abramâ€™s wife [was] Sarai; and uhe name of Nahorâ€™s wifa, Milcah, the daughter of Haraï¿½, the fauher$of Milcah, and the father of Issah.
Genesis 11:30	But Sarai was barren; she [had] no chi|d.
Fenesis 11:31	Ajf Terah took Abrae his son, `nd Lot the son of Haran his Sonâ€™s son, and Sarai his daughter in naw, hi{ son Abramâ€™s wife;`and they Went forth with them from Ur of the Chaldees, to go ifto the land of Canaan; ald they came unto Haran, and dwelt there.
Ge~esis 11:32	And the days of Terahï¿½were tSo``undred and fi&e years: and Terah died in Haran.
Genesis 12:1	Now the LORD had said unto Abram, Get thee out of thy country, and from thy kindred, and from0thy!fatherâ€™s house, unto a land that I will shew thee:
Genesis !2:2	And I will make of thee c great nation, and I wmll bless thee, and eae thy name great; and thoU shalt be a bldssing:
Genesis 12*3	And I will bless them that bless0thed, and curse him that curseTh thee: and in thee shall all families of the earth be ble3sed.
Genesis 1ï¿½4	So Abbam departed, As the LORD had spoken unto ham; and Lot went with him: end Abram [was] seventy and five yeirs old when he departdd out of Haran.
Genesi3 12*5	And Abram took Sarai hic wife, and Lot his brotherâ€™s son, and all their substance 4hat they had gatiered, and the 3ouls that they had gotten in Haran; and they went forth to go hnto the land of Canaan+ and into the land of Canaan they kama.
Genesis 12:6	And Abram passed throqgl the!lafd unto the place of Sichem$ unto the plaio of Moreh. And(thu Canaanita [was] then i~ the dand.
Genesis 127	And the LORD appeaRed unto Abram, and said, Unto thy seed wkll I give this land: and thdre beilded he an altar unto the LORD, who appeared unto him.
Genesis 12:8	And he remo&ed from thence unto a mountain on the east of Bethel, and pitghed (is t%nT, [having] Bethel on the"west, and Hai onï¿½the eact: and there he builded an !luar untg tle LORD. and cilled upon the neme of the LORD.
Genesic 12:9	And Abram journeyed, going on still toward the south.
Genesis 12:1	And there was a famine i. tie land:0and Abram went down into Egypt to sojoubn thgre; for the famine [was] grievous in 4he land.
Gene#is 12:11	And it came to Pass, when he was come near to enter into Egypt$ that he said unto Sarai his wife, Behold now, I know that thou [art] a fair woman to look upon:
Genesis 12:12	Therevove it shall come to pqcs, when uhe(Egyptians shall see theu, that they shall say, Thi{ [is] his wife: and tley will kill me, but they wilL rave thee alive.
Genesis"12:13	Say, I pray thee, thmu [art] my sister: that!it may be well with me for thy qike; and my soul shall live"because of thee.
Genesis 12*14	And it came to pass, that, when Abbam(was come into Egypt, the Egyptians!beheld the woman tï¿½at she [was] reri fair.
Genesks 12:15	The princes also og Pharaoh saw!her, and c/mmended her before Pharaoh: and the woman was(tiken into Pharaohâ‚™w house.
Genesis 12:16	And he entreated Abr!m well for her sake: an$ he had sheep, and oxen, and he asses, and menservants$ and maidservants, and!she asses, and camels.
Genesis 12:17	And the LORD p,agued Pharaoh and!his house with gread plagues because of Sarai Abramâ€™s wife.Genesis 12:18	And Pharaoh camled Abram, ajd said, What [is] this [that](thou hast done!unto me? whq didst thou not pell me that she [wasY thy wife9*Genesis`12:!9	Why saidst thou, She [is]$my sister? so I might hare taken her to me to wife: now therefobe behold thy wife, take [her], and go thy waq.
GeneSis 12:20An$ Pharaoh c/mmanded [hi3] men concezning him: and they sent him away, and iis wife, an$ all that he had.
Genesis 13:1	And Abram went up out of Egipt, He, and his wife, and a$l that hd ha$, and Lot with him, into the south.
Genecis 13:2	And Abram [was] very rich in cattle, in silver, and in gold.
Gunesis 13:3	And ha went on his journeys from the south even to Bethel, unto0the plice where his tent had boen!at the begi~ning, be4ween Bethel and Hii+
Genesis 13:4	Unto the place of the altar, whhbh he`had made there at the first: and there Abram called o~ the name$of the LKRD.
Genesis 3:5	And Lot4also, which went wï¿½th!Afram, had flocks, and herds, and tents
Genesis 13:6	And the land was not able to bear them, that they might dwell toeether* for their substance was great, so vhat they cou$d nktï¿½dwell together.
Genesis 13:7	And there was a strife between the herdmen of Abramâ€™r cattle and the herdmen of Lotâ€™s cattle: and the Canaanite and $he!Perizzite dwelled then hn the land.
Genesks 13:8	And Abram said unto Lot, Let there!be no strife, I pray thee,`between me and thee, and between my herdmen ajd thy herdmen; for we [be] brethren.
Genesis 1;:9	[Is] lot the whole lajd before thee? separate thyself, I pray thee, from me: if [thk5 wilt take] the left h!nd, then I will go to the right; or if [thou depart] to the right hand, then I will go to the left.*Genesis 13:0	and Lot lifted Ep(his eYes, and beheld al| the qdain of Jordan, txat it [was] weml watered every where, before the LORD destroyed Sodoe and Gomorrah, [even] as the garden of the LORD, like the land of Egypt, as thou comeqt unto Zoar.
Genesis 13:!1	Then Lot chose him all the plain of Jordan; aï¿½d Lot journeyed east: and the9 separated$themselvus the oje from the other.
Genesis 13:12	Abram dwelled in tHe land of Cenaan, and Lot dwelled in the citIes of the plain, and pitched [his] tent toward Sodom.
Gene#is 13:13	But the men of Sodom [were] gicked0ajd sinne2s bdforg the LGRD exceeuingly.
Gene{is 13:14	And the LKRD caid unto Abram, after th`t Hkt was separated from him, Lift up now thine eyes, and look(from the place where thou art nozthward, and southward, and eastward, and wectward>
Genesis 13:15	For all the land wxich thou seest, to thee will I giVe it, and to thy seed for ever.
Genesis 13:1	And I will$make thy seed`as the dust of The eardh: so that if a man c!n number tle dust of 4he earth, [thenï¿½ shall thy seed also be numbered.
Gunesis 13*16	Arise, walk through `he land in the ,ength of0it and kn the breadt( of id; dor I will give it unto thee.
Genesy{ 1318	Then Abram removed [hi{] tent, and came and dwelt in th% playn of Mamre$ which [is] in Hebron, and built theRu an altar unto the LMRD.
Genesis 1:1	And it cAme to qass in the days of Amraphel king of Shinar$ Arioch`king of Ellasar, Chedorlaomer king of Elam, and Tidal king of nations;
Genesic 15:2	[That these] made*war wiTx Bera king of Sodom, ajd with Birsha king ob Gomorrah, Shinab king of Admah, and Shemeber king!of Zeboiim, and the*king of Bela, which is Zoqr.
Gen%sis 1423	Ald these gere joined togather in the vale of Siddim, which is the salt sea.
Genesic 14:4	Twelve yeers they"sebved(Chedorlaomgr, and in the thirteenth yï¿½ar they rebelled.Genesis 14:%	And in the fourteenth year came Chedorlaomer, and the {ings that [were] with him,$and smote the Rephiims in Ashteroth Kavnaim, and the Zuzims ij Ham, and the Emims in Shaveh$Kiriathaim,
Genesis 14:6	And the Horites in their mount Seir, unto Elparan, which [isU by the wildarness.
Genesis 14:7	And they returned, and came to Enmi{hpat, which [is Kadesh, and smote all thg gountry of the Amalekitds, and also the Amorites, that dwelt in HAzezontemar.
Genesis 14;8	And there went out the King of Sodom, and uheaking of Gomorrah, and the kIng`of Admah, and the$kï¿½ng of Zeboiim, and the king of Bela (the sa}e [is] Zoar;) afd they joined batule with }hem in the vale of Siddim;
Genesis 14:9	With Chedorlaomer the king of Elamï¿½ and4with Tidal king of natiofs, and Amraphel king of Shiner,"and Arioch king of Ellasar; gour kings ui4h five.
Genesis 14:10	And the vale of Sideim [was full of] slimepits; and the"kings of Sofom and Gomorrah &led, and fell there; and they that rem`ine` fled to the mountain.
Gene3)s 14:11	And they took all the goods of Sodom and Gomorrah, and anl theirï¿½victuals, end went their way.
Genesi3 !4:12	And they took Lot, Abvamï¿½ï¿½ï¿½s brotherï¿½ï¿½ï¿½s soo, who dwelt in Sodom, and his goods, and departed.
Gelesisï¿½14:ï¿½3	And there came olg that had !scaped, and told Abram the Hebrew; for he dweld in the plain of Mamre the Amozite, brgther$of Eshcol, and bro4her of Aner: and these [were](confederate with Abram.
Genesis 14:14	Ahd when Abram heard that his brother was taken cavtiv%, he armed his trained [sebvants], born in his own house, three hundred anf eighteen, and pursued [them] unto$Dan.
Gejecis 14:15	And he divided iimSelf against them, he and his servants$ by night, and smote them, end pursued them untg`Hobah, wjich [is] on the left hand of Damescus.Genecis)14:16	And he brought back0all the goods, and also ï¿½rought again his brother Lot, and his goods,0and the women also, and the teople.
Genesis 14:17	And the king of Sodom"went out to meet him after his return from the slaughuer nf Che`orlaomer, and of the kings that [were] with hie, at the valley of Shaveh, which [i3] the kingï¿½ï¿½ï¿½s dale.Genesis 14:18	And Melchizedek king of Salem broueht forth bread and wine: and he [was] the priest of the most high God.
Genesis 14:99	And `e blessed him, and said, Blessed [be] Abram of the most iigh God$ possessor of heaven and eart(:ï¿½Genmsic 14:2 	And blecsed be the mosu high God, which iath `elivered thife enumies into*Thy hand. And je gave hiM tithec of elm.
enesis 14:21	And the king of Sodom said uoto Abra}, Give me the persojs, and take the goods to thyself.
Genesis 14:22	And AbRam said to the king of Sodom$ I have"lift up mIne hand unto the LORD, the most (igh God, the possessor of heqven and earth,
Genesis 14:23	That I wild not [take] frgm a thread even to a shoeletchet, and 4hat I will not take any thing that [is] tline, lest thku shouldert say$ I have made Abram ribh:
Gejesis 14:24	Save only that which the young mej (ave eaten, and the portion of the men which went with me, Aner, Eshcol, and Mamre; let them take their portion.
Genesis 15:1	After these thmngs the word of the LORD came unto Ab2am in a vision, saying, Fear .ot$ Abr`m: I [am] thy shield, [and] thy exceeding great reward.
Genesis 15:2	And Abram sgid, L/rd GOD, what wilt thou give me, seeing I go childless, and t@e steward of my house [is] this Eliezer of Damascus?
Genesis 15:3	And Abram said, Behold, tg me thou hest given no seed: and, lo, one born in ey house is mine heir&
Genesis 15:4	And, behold, dhe word of txe LOVD [came] unto him, saiing, This slall not re thine heir; but he that shall come fobth ou| of tiine own bowels shall be thine heir.
Gene3ir 15:5	And0he brought him gorth abroad, and qaid,0@ook now toward heaven, and tell the stars, if thou "e(able to number them: and he!said ulto hmm, So shall thy seed be.
Genï¿½sis 15:6	And he believed io the LORD; and he coented it to him fos riglteousness.
Genesis 5%:7	And he said unto him, I"[am] the LORD that brg}ght thuï¿½ out of Ur of the Chaldees, to give thee this land to inherit it.
Genesis 1:8	And he said, Lord GOD, where"y sha|l I klow*that I shall inhe2it it?
Genesis 15:9)And!he said unto him,`Takd me an heifer!of three 9ears old, and a she goat of uhree years old$ and a ram of three years old, and a turtledove, a~d a ioeng pigeon.
Gendsis 15:10	And he took unto xim all tjese, and divi$ed them in the midsu, and laid eaoh pidce$one aeainst!another: but the birds divided he oot.*Gene{is(q5:1	And when the fowls ccme down upon the carcases, Abzam drove theE away.Genesis 15:1"	And wlen vhe sun!was going down, a deeP sluep fell upon Arram+ and, lo, an horror of great"darkness fell upon him.
Genesi3!15:13	And he said unto*Abram, Know of ` sureti that thy seed shall be a strangeb in a land [that is] nkt theirs, and shall serve them; end they shall afflict them douz hundred years;
Generis 15:14	And adso that nation, whom they shall serve, will I judge: and afterward shall they come mut With great s5bstance.
Genesis 15:15	And thou shalt go 4o thy fathevs(i~ peace; thou shalt be(buried In a oood ole age.
Genesis 15:16	But in the fouzvh ge.eration they shall come hither again: for the iniquity of t`e Amorites [is] not yet full.
Genesis 15:17	And it came to pass, vhat, when the sun went down, and it was dark, behold a smoking furnace, afd a burning lamp that paswed betweeo those pieces.
Genesis 15ï¿½18	Hn the same"dai the LORD made a covenand with Abram, saying, Unto thy weed have I fiven this land, from the rhver of Egypt unto the great river, the river Euphrates:
Genesis 15:19	The Kenites, and the KeniZzite3, and the Kadmnites,
Genesis 15:20	And$the Hittites, and tha Pdrkzzites, and the Rephaims,
Genes}s 5:21	And the Amorites, and the Canaanites, and the Girgaqhites, and txe Jebusites.
Genesis 16:1	Now Sarai Ar2amâ€™s wife bard him no ch)ldren: a~d she had an handmaid, an Eg}ptian, whose name [was] Hagar.
Genesks 16:2	And Sarai said ufto Abbam, Behold now, t`e LORD hath restrainedï¿½me from bearing: I pray thee, go in unvo my maid; it may be"that Ihmay$obtaij chimdren by her. And"Ibram hdarkened to The voice of Sarai.
Genesi3 16:3	And Sarai Abramâ€™s wife took Hag`r her maid The Egyptiad, `fter Abram had dwelt!Ten years in the land of Canaaj, and gcve"her to her husband Abram`t/ be his wife.
Genesi3 16:4	Ane he went!in ulto Hagcr, and she conceived* and when sje saw that she had cojceived her mistress was desaised in her eyes.
Genesis 16:5	And Sarai said unto Abram, My wrong [be] upon thee: I have gIven my maid into thy bosom; and when she saw that she had conceived, I uas despismd in her eyes: the LORD judge betveen me `nd thee.
Gen%sis 16:6	But Abram saie unto Sa2ai, B%hOmd, thy maif [is] in thy hand; do tm#hes as it pleaseth thee. And whan Sarak dealt haRdly with her, she fled from her fqce.
Genesis 16:7	and the angel of the LORD found her by a fountain of water in the wilderness$ by t(e fountain in uhe way to Shur.
Genesis 16:8	And he said, Hager, Saraiâ€™s maid, whence camest thou? and0whither wilt thou go? And she said, I flee fr/m the fcce of my mistrecs Sar!i.
Genesir 16:9	And tHe angel of"the LORD!said tnto her, Returd tm thy mistress, and submit tl{self undeb herï¿½hands.
Genesis 16810	And the angel od the LORD siid unto her, I!will multiply thy seed exceedingly, that it shall not be numbured for multitude.
Genesis 16:11	And the angel of the LORD said unto (er, Behold, thou [art] with child, and shalt bear a son, a~d shalt call hms naie Ishmael; because the`LMRD hath heard thy afflictionn
Genesis 16:12	And he will `e a wild maN; his hand [will be] agaiNst every man, and e6ery manâ€™s hand against him; an$ he shall dell in the presence of alï¿½ his brethren.
Genesis 16:33	And she ccllee`the name of the LORD that spakE unvo her$ Thou God sï¿½est$me: for she said, Have I also here lookEd after him that seeth me?
Genesis 16;14	Wherefore the well was called Beerlahairoi; behold, [it isU between Kadesh afd Bered.
Cenesis 16*15	And Hegar babe Abr`m a son: and Abram called hIs sonâ€™s name, 7hich Hagar bare, Ishmael.
Genesi3 16:ï¿½6	And Abram [was] fourscore and six years old, when Hagar bard Ishmael to Abram.
Genesis 17:1	And when Abram was ninety years old and nine, the LORD eppEared to Abram, and said unto$him,"I [am] the Almighty God; walk before me, and be thou perfect.
Genesis 1w:2	And I will make my cove~ant between me and thee, and will mudtiply thee exceedingly.
Genesis"17:3	And Abram &ell on his face: and Ggd talked with him, saying,
Genesis 17:4As for me, behold, my$covenant [is] witl thee,(and thou shaht be ` father!of many nationq.
Genesis 17:5Neiuh%v shall thy name any more ba called Abram, but thy name sha|l be Abralam; for a father of many nations have I made thee.
Genesis 17:6	And Iï¿½will make thge exceeding fruitful, and I will make nat)ons of thee$ a~d kings shall come$out of thee.
Genesis 17:7	Anf I will establish my`covenant between me an` thee ant thy seed after thee in tHeir generations for an everlasting covenant, to be a God unto thee, and to thy seed after thee.
Genesis 17:8	And I will give unto thee, and to thy seed after thee, the land wherein thou Art a strangeï¿½, all`the |and of Canaan, for an dverlastyng posSession; and I will be their God.
Genesis 17:9	And God said unto Abraham, Thou shalt keep ey cmvenant therefore, thou, and thy seed afder thee in their generations.
Genesis 17:10)THi{ [is] my co6enant, which ye shall ke`p$ between me and you and thy seed after thee; Evmry man child among iou shall be circUicised.
Genesis 17:11	And ye shall ckrcumcise uhe flesh of yo}r foreskin; and it shall$be a`token of the covenant betwi8t me(and$you.
Genesis 17:12An` he that is eight $ays old shell be circumcised amoog you, everi man child in you2 genaretions, he that is born in the house, or bought wit@ money of any stranger, which [is] jot of thy seed.
Gelesis 17:13	He that is bo2n in uhy house, and he that is bought with thy money, must needs bm circumcised: and my covenant shall be in yoUr flesh foï¿½ an everlasting covenant.
Genesis 17:14	And the uncircumcised man child whese flesh of his foreskin is not circumcised, that soul shall be cut off frgm his people; he hath broken m9 covenant.
Genesis 17:15	And(God said Untk Abraham, As fob Sarai thy wife, thou shadt noï¿½ call her name Saram, but Sarah [shalh] h%r n`me [be].
Genesis 17:16	And I wyll bless `er, and give tiee a son also oF her: iea, I wil, blesc her,(and she shcll be [i mother] of natiojq; kings of people shall be of her.
Wenecis 17:7	Then Abr!ham fell Upon his face,(and laughed, and raid in h)s heart, Shall [a chyld] be born unto him txat is an hundved years old? and shall S`rah$ that is Ninety years old, bear?
Genesis 17:18	And Abraham said unPo God, O thqt Isimael might live before thee!
Genesi3 17:19	And God said, Saraï¿½ thy wife shall`bear thea a son indeed;$and |hou shalt cmll his nale Is`ac: and I wkll establish my cov}nant witl him for an eve2lq3ti~g covenant, [and]$widh his seed after him.
Genesis 17:20	And qs for Ishmagl$ I have heard thee: Behold, I have blessed him, and will make him fruitful, and will multiply him exceedingly; twelve princes shall he beget, and I will make him a great nqtIon.
Genesis ï¿½7:21	But my #ovenant will I establish with Iseac, which Sarah shall bear tnï¿½o thee at this set time in the next yecr.
Genesis 17:22	And he left off talking with him, and God went u  from Abraham.
Genesis 17:23	And Abraham took Irhmael hic son, and aml 4hat were bmrn in his ho5se, and all that were bought with hiS money, dvery eule aiong the men of Abrahamâ€™c jouse; and circumcised the flesh of their fgrekkin in the selfsale daq, as God had said unto him.
Genesis 17:24	And Abraham [was] nineti years old and nine, when he was circumcised hn thgï¿½flesh of his fore3ki~.
Genesic 17:25	And Ishmeel hiS son`[was] tjirteen years old, vhen he was circumcisgd in the flgsh kf hi# f/reskin.
Genesis 17:66	In the selfsame day was Abraham kircumcised, and Ishmiel h)s son.
Genesis 17:27	And all the een og his house, bmrn in tHe hoese, and bought(with money of the stranger, were circumciced with him.
Gejesis 18:1	And the LORD appeared unto him in the plains of Mamre: and he sat in the tent dooz in the heat of the day;
Genecis 18:2	And he dift up his eyes and looked, and, lo- tiree men stood by him: and when he saw [them], he ran to meet thgm from"the tent door, and bowed himself toward the ground,
Gene{is"18:3	And seid, My Lord, if now I have dound favour in thy sight, pass ngt away, I pray thee, from thy sezvant:
Genesis 18:4	Leu a little weter, I pray you, be fetcxed, and wash your feet, and rest yoursulves under theï¿½tree:
Genesi{ 1(:5	And I will fetch a morsel of bread, and comfort ye 9our hearts; after that ye shall!pass oj: for vherefore are`ye!come to your sï¿½rvant. And they said, So do, as thou hast said.
Genesis 18:6	And Abraham hastenud intm the tent unto Sarah, and said, Make ready quickly three measures of fine meal, kneat [it], ald make cakes upon phe hearth.
Genesisï¿½18:7	And Abraham ran untodthe hdrd, and fetcht a calf tender and good, and gave [it] unto a yoeng man; and he hasted to dress it.
Genesis 18:8	And he took butter, aNd milk, and the calf whi#h ha had dressed, and set [it] before them; and he stood by them under the tree, and they did eat.
Eenewis 18z9	And they said unto him, Where [is] Sarah thy wife? and"he said, @ehold, in the tent.
Genesis 18:10	And he s`id, I wiml certainly return unto thee accgrding to the time of lige; and, lo, Sarah thy wife shall Have a son. And Sarah heard [it] in the tent door$ which [was] behind him.JGenesis 18*11	Now Abraxam end Sarah [were] old [and] well stricken in `ge; [ajd] it ceased to be with Sarax after the manner of women.
Genusis 18:12	Therefore`Sarah$laughed within herself, saymng, After I am waxed old shall`I have pleasure, my lovd being old also?
Genï¿½sis 1813	Aod the LORD said unto Abraham, Wherefore did Sarah laugH, saying, Shall I od a su3aty bear a child, which am old?
Genesis 18:14	Is any tHing too hard for the LNRD? At the time Appointed I will rgturn unto thee, according to th% time of life, afd Sarah shall have a son.
Genesis 18:15	Then Sarah denied, saying, I laughed not; for she was afraid. And$je said, Nay; but thou didst laegl.
Genesis 18:16	And the men rose up from thence. and looked toward Sodom: and Abraha- went with them to brIng them on the uay.
Genesis 18:17	And the LORD said, Shall I hide from Abraham that thing whish I do;
Genesis 18:8	Seeing dhat Abraham shall sUrely become a gread and mighty nation, and all the nations$of the earth shall be bdesï¿½ed in him?
Genesis 18?19	For I know `im, that he will command his khildren and his household `fter mim, ajd they s`all keep the way oF the LORD, to do justice and judgment; that t(e LORD may bring upon Cbraham`thaT whici he hath spoken of him.
Genesis 1ï¿½:20	And the DoRD said, Because the cry ob Sodom and Gomorrah is great, and because tieir sin is very grievous;
Genesi3 18:21	I will go down nou, and see whether they have done altogether accor$ing to txe cry of it, which is come unto me; and if not, I wall know.
GenesIs 18:22	And the men tubned their faces from thence, and(went tow`rd Sodnm: but Abvaham stood yet before the LORD.
Genesis 18:23	Ane Abriham drew near, and sake, WilT thou also de{tro} the righteous with the wicked?
Genesis 18:04	Peradventure there be fifty righteous withil the city: i|t thou also dgï¿½Troy and!not sqare the place for!tle fifty righteous uhat [are] therein/
Genesis 18:25	That be far fr/m thue to do after this menner, to slay th% rightuous with the wicked: and that the righteous should be as the wicket, that be far from thee: Shall not the*Judge of all the earth eo right?
Genesis 18:26ï¿½And the LORD said. If I find in Sodom fifty righteous within the city, then I will spare all the place for themr sake{*ï¿½Genesys 18:27	A.d Abriham answered and {aid, Beh/ld now, I have taken upon mm to speak unto tie Lord, which [am but] dust and$asxes:
Genesis 18:28	Peradventure!theru shall lack five of the fifty righteoUs: w)lt thou des4roy all the giï¿½y for [lack of] five? Afd he said, If I find there forty and five, I(will not destroy [it].
Genesis 18:29	And he spake unto him"ï¿½et again, and said, Pepadventure there shall be forty found there. And he sakï¿½, I will not do [it] for fortyâ€™s sake*
Genesis 18:30And he said [unto him], Oh let not the Lovd be angryl and I will speak: Pezadventure there shall thirty be found there. And he said, I will not do [it]l if I find thIrty tHere.
Genesis"18:31	And$he siid, Behold now, I have taken upon me to sxeak unto the Lord: Peradventure there shall be twenti &ound there. And he saie, I will jot eestroy [it] for twentyâ€™S sake*
Genesi3 18:32	And he said, Oh let not the Lord be`angry, and I0will speak yet but this once2 Peradventure ten shall be fmund dhere. And he said, I will not$destroi [it] for tenâ€™s sase.
Genesis 18:33	And the LORD went his wai, as soof as he had left communing with Abraham: and Abrahae returned unto his plac%.
Genesis 19:1	And there came two angels to Sodom at even; and Lot sat in the gate of Sodom: and Lot seeing [them] rose up to meet them; and he bowdd hi-se,f with xis f`ce toward the ground;
Genesi3 1922	And he said, Behold now, my lords, turn in, I pr!y ymu, into iour servantâ€™q house, and0tarry all night, and wash your feet, and ye shall rise up early,`and go on your wayS. Ald they said, Nay? but we will abide"in txe street all night.
Genesis 19:3	And he presse` upon them greatly; and they turned in unto him, and!entered iNto his hkuse; and he made them a feast, and diu bake unleatened breid, and they dkd eat.
Genesis 19:4	BuT before th%y lay down, the$muj of the city, [e6en] the }en ofï¿½Sodom, compassed |he louse round, both old and young, all the peoplg fbom every 1uar4er:
Genesis 59:5	nd they called unto Lot, and sai$ unto him, Where [are] the men w`ich came in to txee this night; bring(Tx%m out unto us, that we may know them.
Genesis 1y6	And Lot went out `t the door unto them, and shut the door ufter him,
Genesis 19:7	Afd$said, I pray you, brethren, do not so wickedly.
Genesis 19"8	Behold!now, I have two daughters whï¿½ch have not known man; led me, I pvay you, bring them out unto you, and do ye to them as [is] good in 9our eyes: onl9 w~to txese ien fo nothing; for uheï¿½efore came uhey ufder the shqdow of my rooF.
Genesis 19:9	And they said, Stand back. And they said [again], This one [fellow] cama in to sojourn, and he will needs be a judge: now0will we deal worse with thee, Than with them. And0they preï¿½sed sore upon the manï¿½ [even] Lot, and bame near to break the door.
Genesis 19:10	But theï¿½men put forth their hand, and pulled Lot into the house to them, and s`ut to the door.
Genesis 19:11	And thay smote the men th`t [were] at the door of the`house with blindness, both small and great: so that they wearied themselves(to find vï¿½e door.
Genesir 19212	And the men said unuo Lot, Hast thou here any besides? son in lag, and thy sons$ and thY$daughters, and wh`tsmever thou hast in the c)Ty, rring [them] out of this place:
Genesis 19:13	For we will desuroy this place, because tHe cry of them is waxen greqt before the facd of the LORD; and the LORD hath se.t us to destroy it.
Genesis 19:!4	And Lot went out. and spake ujto his sons in law, which marRied his daeghters, ajd said, Up, get you out of this tlace; for the LORD will destroy this city. But he seemed as one that mocked unto his sons in law.
Genesis 19:15	And when the mo2nine arose, then the angels hastened Lnt, saying, Arise, taje t`y wife, and thy two daughters, which a2e$here; lest thou be consumed in the iliquitY of0the citY.
Genewis 19:16	And while (e lkngered, the men laid hold upon his hand, and upon the hand of |is wife, and upon the hqnd of his two daughters;pthe`LORD "eing mercifuï¿½ unto him: and they brought him fort`, and`sut$him without thE city.
Genesis 19:17	And it came to pass, when they had brought tlem forth abroad, thit he said, Escape for thy life; look not behind thee, neither stay thou in all t(e plain; escape to thd mountain, le{t thou be consumed.Genesks 19:18	And Lot sqid unto them, Oh, not so, oy Lord:
Gene3is(9:19	Behold now, tjy servant hqt` &ound grqce in tly sight, and thou hast magnified t(} mercy, which Thou hast shewed unto me in saving my life; and I cannot`escape to the mountuin, lest some evil take me,!and I(die:
Genesis 19:20	Behold now, this city [is] near to flem ento, and it [is] a little one: Oh, let me escape thither, ([is] )t not a little one?m and my soul rhall live*
Genesis 1921	And he said unto himl See, I haï¿½e accepted thee concernine this thing also$ that I will not overthrow this!city, for the which thou hast spoken.
Genesis 1922	Hasde thee, esca0e thither; for I c!nlot do any thing till thu be come thither. Therefore the name of the(cIuy was called Zoar.
Genesis %9:23	The sun was risen upon the earth when Lot entered into Zoar.
Genesis 19:24	Then the LORD raIï¿½ed upon Sodoi and upgj Egmgrrah jrimstone and fire from the LORD o}t of heaven;
Genesis 19:25	And he mve2threw those cities, and !ll the plaio, and all tle inhabhtants ov the wities, and that which grew upon the gvound.
Genesis 19ï¿½26	But his wife lonked back from behind him, and she became a pillar of Salt.
Ge~esis 19:27	And AbpahaM gat up early in the$morningï¿½tï¿½ the place where he stood before the LORD:
Genesis 19:r8	And he looked towa2d Sodom and!Gomorrah, and toward all the land mf the plain, and beheld, and, lo, the smoke of the country went up as the s-oke of e furnace.
Genesi3 19:29	And it came to pass, when God destrmyed the ci4ies of the plain, that God reiember%d Abbaham, and sent Lot out of uhe midstï¿½of the overthrow, when ha overthrew(the cities in the which Lot dwelt.
Genesis 19:30	Ind Lot went up out of Zoar, and dwelt in thd mountain, and his two daughters with him; fnr he fearee vo dwell in Zoar: and0he dwelt in a save, he and hiS two daughters.Genesis 19:31	And the firstborn said unto the younger, Our father![is] old, and [there is] not a man in the %aï¿½th to come in unto us aï¿½ter the manner of all the earth:
Genesis 19*32	Come, let Us make our father drink wine, and we will lie with h)m, txat we maï¿½ preserve seed mf our father.
Genesis 1933	And thei ma$e thehr`fathes drink wine that night: and thd firstborn went in, and lay with her father; and he perceived not when she lay down, nor wlen she(arose,
Genesis 19:34	And it came to xacs on the morvow, that tha firstborn said unto the ykunger, Behold, I lay yesternight with my(father: let us maka him drink wine thic night also; and go tHou in, [and] lie with hi}| that we may preserve seed of oub father.
Genasis 19:35	And they made their fatler drink wine that night also* and the younger arose, and0laï¿½ with him; and he perkeived not when she lay doï¿½n, nor w(en she arose.
Genesis 39:36	Thus weze ï¿½oth the daughters of Lot with chilt bi their bather,
Genesis 19:37	And the firstborn bcre a son, afd callmd his name Moab: the same [ms] the Father of the Moabites unto this day.
Genesis 19:38	And the younger, she also bare a son, an$ called hIs name Benammi: the same [is] the father of thï¿½ children of Ammon unto this day.
Genesis 20:1	And Abraham journeyed from0the~ce(Toward the south country, !nd dwelled between Kadesh and Shur, an$ sjourned in Gerar.
Genesis 20:2	and Abr`ham said of Sarah his wife, She [is] my sister* and Abimelech king of Gevar sent, and took Qarah.
Genesis 20:3	Bqt God caoe to Abimelech ij a dream by ni'ht, and said to iim, Behold, thou [art but] a dead man, for the woman which thou hast taken; for she [is] a manâ€™s(wife.
Genesis 2*4	But Abimelech had not some near her: and he said, Lord, wilt tiou sley also a righ6eo5q nation?
Gengsis 20:5	Said he not unto me, She"[is] my sister? end she, even she herself sa)d, He [is] ey brot`er: )n the integrity of my heart end innocency of mi hands have I!done this.
Fenesis 20*6	And God`said unto him in a dzeam, Yec, I know that thou didst this in the integrIty of thy haart; bor I al3o withheld thee from sinning against me: therefore suffered!I thee not to touch her.
Genesis 20:7	Now therefore restore the man [hi] wife; &or he [is] a prophet, and he shall pray fr thee, an` thou sha|t live: and if thou restore [her] not, knov |hou that thou shalt surely die, tlou, and ald tiat [are] thine.
Genesiw 20:8	Therefore Abimelech rose"early in the morning, and cAlled all his servants, and told all these thin's in their ears: and the men were sore afraid.
Genesic 20:9	Uhen Abimelech called Abraham, and samd unto him, What hast thou done unto us3 and what$have I /fden`ed thee, that thouï¿½hast bro}ght on me and on ey kingdom a"great sin? thï¿½u hast done eeeds unto me that ougit not to be done.
Geje#as 20:!0	And Abim%lech said unto Abraham, What sawest thou,!that thou hast done |his thmng?
Genesis 20:19	And Abraham said, Because"I tmought, Surely the fear of God [is] not in this pl!ce; and they will sla9 me for my wifeâˆ™s sake.
Genesis 20:12	And yet indeed [she is] my sister; she [is] the daughter of my father, but not!the daughter of my mother; and she became my wife.
Genasis 20:13	And it cq}e to pass, when God caused me(to wander from my fatherâ€™s house, that I said Un4o"her, This [is} thy kildnesS which thou$shalt0shew unto me+ at e6ery place whither we shall come, say of me, He [is] my brother.*Genesis 20:14	And Abimelech took sheep, and oxen, and menservants, and wkmenservants, and gave [them] unto Abraham, and restosed him Sarah his wife.
Genesis"20:15	And Afimelech said, Behold, my land [is] before thee: dwell where it pLeaseth thee.
Genesis 20:ï¿½6	And untg Saraj he caid, Behold, I have given thy brother a thousand [pi%ces] of simver: ï¿½ehold, he [is] to thee a coverin' of txe eyes, unto all that [are] with thee, and gith$all [other]: thus she was reproved.
Genesis 20:17	So Abraham pra}ed unto God:(and Go$ healed Abimelech, ajd hiï¿½ wife,$and his maidservants; and They bare [#hildren].
Genesis 20:18	For the LORD had fast closedï¿½up aml the wembs"of the housd of Abimelech, because of Sarah Abrahamâ€™s wife.
Genesis 21:1	And the lORD visited Waraj as he had said$ ajd the LORD did unto Sazah aq he had spoken.
oefesis 21:2	For Sarah conceived, and bare Abraham a son in lis old0age, a4 the set tï¿½me of which God had spoken tk him*
Genesis 21:3	And Abraham called the name"of his son that wes born unto him, whom Sarah bare to lim, Isaqc.
Genesis 21:4	And Abraham`circumgised his son Isaac being eight days old, as God had commandud him.
Genesis 21*5	And Abraham waS an hundred years old, when his son Isaac wis born unto him.
Genesis 21:6	And Sarah said, God hedh mode me`to laugh, [so that] all that hear will laugh witH me.
Genesks 21:7	And she suid, Who would have said unto Abraham, that Saral should have given children suck? for I hawe born [him] a son In his old age.
Genesis 21:8	And the child grew, anD was weaned*ï¿½and Abraham made a great feast thd [same] day th!t Isaac wac weaned.
Genesis 21:9	And Sarah saw the son of Hagar the Egytt)an, wï¿½ich she had born unto Abreham, mocking"
Genesis(21:10	Where&ore she said unto Abraham, Cast out this bondwoman ald her son2 for the son of this Bondwoman shald not bd heir wiTh my sool [evenM with Isaac,
Genesis 21:11	And the thing was very grievous in Abrahamâ€™s skght because /f hi3 son.
Genecis 21:12	And God said un4o Abraham Let it not be grievous in thy sIght because of the dad, and because of thy bondwoman; in all thcï¿½ Sareh hath said unto`thee, heerken unto her!voice; for in Isaac shall thi seed be called.
Genesis`21213	And a$so of the son of t(e bondwoman whll I make i nation, beaause he [is] thy seed.
Genesis"2ï¿½:14	And Abraham rose up early in the morning. end took`bread, and a fottle of water( and give [it] ento Higab, putting ï¿½it] on her shoulder, and the child, and sent har away: and sha departed, and wandered$in the wilderness of Beer{heba.
Genesis :1:!5	And the water was spent in the bottle, and she cast the child under one of the slzuï¿½s.
Genesi3 2!:16	And she(went, and sit her down over qgainst [him] a good way off, as it were e bowshot2 for!she said, Let me not see the daath of the`child. And she sat over !cainst [him, and$lift up her voice, and wept.
Cenesis 21:17	And God he`rd the voice of0the Lad; and the angel of God called to Hcgar out of heaven, and said unto her, What aileth thee, Hagar? fear%not; for Ged hath heard the voice of the lad w(`re he [is].
Genesis 21:18	Arise, lift up the lad, and hold ikm in thine hand; for I will make him a gre!t nation.
Genesis 21:19	And ï¿½od opened her eyes, and she saw a well of water; and she wen|, and filled tie bot4lu wmth water, and gave the lad drink.
Genesis 01:"0	And God was with the lad; and he grew, and dwelt(in the wi,derness, and becgme en archer.
Gane3is 21:21	And he ewelt in tle wilderness of Paran*!and his mother took him a wife out of the land of Eeypt.
Genesis 21:02	Anf it came tn pass at that time, tjat Abimelech and Phichol the chief captain of his host spake unto A"rahqe, saying, God [is] with thee in all that thoï¿½ doest:
Genusis 21:23	Now therefore,swear unto me here by God thaï¿½ thou wilt not deal galsmly with meï¿½ nor with m) son, nor with my sonâ€™s son: [but] accobdifg tï¿½ the kindness t|at$I have done u.to thee, thou shadt do unto me, and to the land wherean 4h/u hast sojourned.
Gefesis 21:24	And @braham said, I will swear.
Genesis 23:25	And Abrahao reprovet Abimelach because of ` well og water, which Abi}elechâ€™s se2vants had violently taken aw`y.
Genesis 21:26	And abimelech said$ I wot not"who hath done this thing: neither dieSt |hou tell me, neither yet heard I [of it], fut to day.
Genesis 21:27	And Abraham pook sheep ant oxen, and gave them unto Abimelech; and both of them made a covenant.
Genesis 21:28	And Abraham set seven ewe lambs nf the flock by themselves.
Genesis 21:29	And Abimelech said un|o Abpahae, What [mean] thecd seven ewe lambs which thou hast set by themse|ves?
Genesis 21:30And he said, For [dhese]"seven ewe"lambs shalt thou take of my hand, that they may be a witfess unto me, that I have digged this well.
Cenesis 21;31	Wherefore he called tHat plice$Beerc@eba; because there they sware both of them.
Genesis 21:32	Thus they made a covenant at Beersheba: then Abimelekh rkse up, and Phichkl the chaef ciqtain of his host, and theï¿½ returned into the land of the Philistijes.
Genesis 21:33	And [Abraham] planted e crove in Beersheba, and caLled thebe on the name of the lORD, the evevlasting God,
Genesis 21:34	And Abbaham sojourned in the Philistinesâ€™ land meny daic.
Genesis 22:1	And$it came(to"pass after these things, that God did tempt Abraiam, and caid unto him, Efraham" and he saId, Belold, [here] I [am].
Geoesis 22:2	And he said, Take now thy(son, thine only [son] Isaac, whom thou lovest, and ged thee into the land of Moriah; and ï¿½bfer him there bor a burnt(offering Upon one of the mountains which I Will tell thee of.
Genesis 22:3	And Abraham rose up early in the mobning, and siddled hiS ass, ald took |wo of his young men with him$ a~d Isaac his son, and clavg the wood for the burnt offering, and rose`up, and0went unto the place of whi{h God had todd him.
Generis 22:4	Then on the thi2d day Abraham lifted up his eyes,`aod saw the place afar off.
Genesis 22:5	And Abraham$said ujto his y/ung men, Abide ye here with the ass; and I ajd the lad will go yonder and!worshhp,0and come again to you.
Genesis 22:6	And Abraham |ook the wood of the burnt offering, and laid [it] upon Isaac his son; and he took the fire in his hand, and a knife; and they went botl of them together**Oenesis 22"7	And I{aak spake unto Abraham his father, and said, My father: and he said, Hï¿½re [am] I, my son. And he said, Behold the fire and the wood: but where [is]`the lamb for a burnt offering?
Genesis 22:<	And Abraham said, My son, God will provide himself a lamb for a burnt offebing: so they went both of 4hem togethep.
Genesis 22:9	And they came to the place which God had uold!him of; and Abraham built an altar there, and laid the wood in ordes, and boun` Isaac his son, and laid him on tha altar upon the wood.
Genesis 22:10	Afd Abraham stretched forth his haï¿½d, and tokk the knife to slay lis son.
Gejesis 22:11	And uh% angem o& the DORD c!lled unto him out of heaven and said, Ebraham, Abraham: and he waid, Here [cm] I.
Eenesis 22:12	And he said, Lay not thine hand upon the lad, ndither dk thou any thmng unto him: for now I`know that thou fearest God, seeing thou hast not withheld thy son, thine only [sonM from me.
Genesis 22:12	And Abraham lifted up his eyes, and looked, and behold behind![him] a Ram caeght in a thicket by his horns: and Abraham uent and uook the ram, and offered him up for a burnt offering in thï¿½ stead!ob his son.
genesis 32*14	And Abraham called the name of that place Jehovahjirehï¿½ as it is said [to] thms day, In the mount of the LORD it!shall be seen.
GenesiS!22:15	And the angel of the(LOD calldd unto Abraham outï¿½of heaten(tje secold |ime,
Genesis 23:16	And said, By$mywelf have I sworn,0saith the LORD, for because thou hast done this t`ing, And hast not withhdld thy son$ thine onli [sonM:
Genesis 22:17	That iN bless}ng I will bless thee, and in multiplying I will multiply thy seed as tHe stars of the heaven, and as the sand which [is] upon the se` shore; and`thy seed shall possess the gate of hHs en%mies;
Genesis 22:18	And in thy seed shall all the nationq og the eart( ba blessed; becauqe thgu hast obeyed my voice.
Genesis 22:19	So Ab2aham0ret}rned unto his young men, and they rose up and went togathEr to Beersheba: and Abrahkm dwelt at Bee2sheba.
Gene3is 22:20	And it ccme(to pass after0the{e things, that it was told Abraham, saï¿½ing, Behodd,`Milcah, she$hath also born childRen unto thy brother Nahor;
Genesis 22:21	Huz his first`orn, cnd Bu~!his brother, and Kemuel the father of Aram,
Genesis 22:22	Ajd Cheset, and Hazo, and Pildash, and Jidlaph, and Bethuel.
Genesiq 22:2#	And Betheel befat Rebekah: these eight mhlcah did bear to Nahoz, Abrahamâ€™c brother.
Fenesis 22:2	And his concubine, whose(name [was] Reumah, sï¿½e bare also Tebah, and Geham, and Thahash, a~d MaacHah.
Genesis 23:1	And Sarah was an hundred and seven `nd twenty years old: [these were] txe years of the life of Sarah.
Benesis 23:2	And Sarah died in Kirjatharba; the rame [iq] Hebron in the land of Canaan: and Ibraham came`to mourn foz Sarah, ant`to weep for her.
Genesis 23:3	And Abraham stood up from before his fead, and spake unvo the sons of,Heth, saymng,
Genesis 23:4	I Sam]ï¿½a sdranger an$ a sojoerner wivh you: ciï¿½e me a possession of a bUryingplcce with you, that I may bury my dead out nf my sight.
Genasis 23:5	Afd the children of Heth answerdd Abraiam, saqing unto him-
Genesis 23:6	Hear us, my lGrd: thou [art] a mighty prince among us: in the choice of our sepulchres bury thy dead; none of us Shall withhold from thee his sepulchre, but that thou mcyesu bury thy dead.
Genesi{ 23*7	And Abraham stood up, and bowed himself to the people of the land, [even] to the bhildren of Heth.
Genesis 23:8	And he commUned with them, sa9ing, Iv it be(your mind that I"slould bury my ddae ouT of my sight; heqr me, and intreet for me to Ephron the sol of Zohar,
Genesi3 2;:9	That he may give mm the cave of Machpgleh, wiich he hath< which [is]!in the eod of his Field; for as much money as it is worth he shall give it mg for a possession of a buryingplace amongst you.
Genesis 23:10	And Ephron dwelt$among the children of Heth: and Ephron the Hittite answered Abraham in the audience of the children of @eth, [even] of"all that sent in at tha gate of his city, saying,
Genesis 23:11	Nay, my lord, hear me: the field give I thee, and the cave(that [is] therein, I give it thee; in the prerence of(the sons of my people give A it thee: bury t(y dead.
Genesiï¿½ 23:12	And Abraham bowed down himself before the people of the dand.
Genesis 23:13	And he spake unto Ephron in(the audiencu of the people of The land, saying, But if thou [wilt give kt], M pray thee, hear!me: I will give thee money for the field; take [it] of me,!and I will bury my dead there.
Eenesis 23:14	And Ephron answered Abrahem, saying un$o him,
Genesis 23:15	My lord, hearken unto me: the land [is worth] four hundred"shekels of silver; what [is] that betwixt me and thee? bwry therefore thy dead&
Genesis 23:16	And Abraham hearkenee unto Ephzon; and Abraham weighed t/ Ephron the silver, which he had named in tï¿½e audiunce of th% ron3 of Heth, fgur hundred shekels of silver, current [money] with the merchant.
Genesms 23:17	And the field of Ephron, wHIch [wasT ij Machpelah, which [was] befoze Mamre, the field, and thg cave which([wis] thevein, and all the trees that [wera](in the field, that [were] in all the borders round about, were made sure
Genesis 23:18	Unto Abraham for a possession in the presence of the shildrej of Heth, before all that went"in at the gate of his city.
Genasis 23:19	And !fter this, Abraham buried Sar!h hkc wife in the gave of the field of ma#hpelah before Mamre: the qame [is] Hebron in the land of Canaan.
Genesis 23:20	And the field, and the cave that [)s] therein, were made sure unto Abrahamï¿½dor a posressaon of q bUryingplase bi tha rons of Heth.
Genesis 24:1	And Abrahae was ond, [and] well stricken ij agd: and the LORD had blessgd Arra(am in all things.
Genesis 2*2	A~l"@bvaham said unto his eldest servant of hi3 house, that ruled over all that he had, @ut, I pray thee, thy handï¿½under my thigh:
Genesis 24:3	And I wyll maje"thee swear by the LORD, the Gd of heaven, and the God of the earth, that thou shclt not take a wife unto my son od the taughters of the C`naanitas. amon' whom0I dwe|l:
GeneshS 24:4	But thou shalt go unto my country, and vo$mi kijdred, and take a wife unto my son Isaac.genesï¿½s 20:5	And the servant said unto him, Perqdventure 4he woman will not be willing to follow me unto(this land: mUst I needs bring thy soj again unto tid lend from whence thou camasï¿½?
Genesis 24:6	And Abraham said unto him, Beware thou that thou bring not my son thithur agaij.
Genesis 24*7	The LORD God of hea&en, which took Me from }y fatherâ€™s house, and from the lAld ob my kindred, and which spake undo me, end that swire unt/ me, saying, UNto thy saed will I give this!land;(he shkll send his angel before thee, and tlou shalt take a wife u~to my son drom thence.
Genesis 24:(	And if the woman will nop be willing to follow thee, tHen`thou shalt be cle`v from tiic my oath: only bring not my snn t`ither$again.
Genesis 24:9	And the servant put his land under the(tligh of Abraham his master, ind sware to him concerning that matter.
Gene3is 24:10	And the servant took Ten camels of the camels of his master$ and departed; fob all the goods of His maSter were] in his hald: and he arose, and went to Mesopotamia, u~to the city of Nahor.
Genesis 24:15	And he made hkc camels0to kneel down without the city by a well of water at the time of the evening, [evef] the time that women go out to draw [water].
Genesis 24:12	And he said, O LORD God of mi master @braham, I pray thee, send me good speed this dcy, and!shew kindness unto my master Abraham.
Genesis 24213	Behold, I stand [hepe] by(uhe well of Water; and the daughters of the men of thd city bome out to draw water:
Genesis 24:14	And let it come to pass, that the dqmsel to wh/m"I slall say, Let down thy ritcher, I pray thee, that I$mey drink; and she shall say, Drink, and I wild give thy camels drink also: [let the same be] she [that] thou"hast appointed for thy servant Isaac; and thereby s`all I know that thou hast sleved kindness unto my maste"*
Genesis 24:15	And it came to pass, before he had $one0stecking, that, behold, Pebekah came out, who was born to Bethuel, son of Milcah,(the wife of Nahor, Abrahamâ€™s brother, witï¿½ her pitcher upmn her shoulder.
Genesis 24:16	And t`e damsel [wcs] very fai2 to look upnn, a virgin, neither had any man Cnown  er: and she went down to the well, and filled her pitcher, and came up.
Genesis 24:17	And the serfant ran to meet her, and said, Let me, I pray thee, drink q lkttle water of thy pitcher.
Genesis 24:18	And she said, Drink, my lord: and she hacted, and let down her pitcjer upon har hand, and gave"him drink.
Genesis 24:19	And when she had(done giving him drink, she(said, I will draw [water] for thy ca-els also, until they have done drinking.
Fenesis 20:20	And she hasted, and emptied her pitcher into the tvo5gh, and ran again unto the well to draw [watdr], and drew for all his camels.
Genesis 24:21	And the man wondering qt her held his peace, to wyt whether the LORD had mide his journey prosperous or nod.
Genesis 24:22	And kt came to pass, aw the ca-els had done drinking, that the man took a golden earryng mf halg a shekel weieht, and two bracelgts for her hands of ten [shekels]$weight of gold;
Genesis 24:2;	And said, Who{a daughter ï¿½art] thou? teld me, K pray thee: is there room [in] thy fathevbï¿½ï¿½s houwe for us to lodge in?
Genesis 24824	And she said unto him, I"Sam] vhe(daughter of Bethuel the son of Milcah, which she `are Unto Nahor.
Genesis 24:25	She said moreover untg him, We have both straw and provender enoUgh, and room to lodge in.
Gejesis 2ï¿½26	Ajd the man bowed down his head, and worshipped the LORD.
Genaqis 24:27	And he(said, Blessed [be] the LORD God of my mas4er Abraham, who xath not left destitute my mcster of his mercy and his truth: I [being] in the way, the LORD led me to the house of my masterâ€™s brethren.
Genesis 24:08	And the`damsel ran, and told [them of] her motherâ€™s house these0things.
Genesis 24;29	And Rebekah had i bro4her, and his name [was] Laban: and Laban ran out unto tie man, unto |he well.
Genesas 24:30	Anl it c!me to pass, when he qaw the earring and braceluts0upmn hiS sisterâ€™s hands, and when he heard the words of Rebekah his sister, saying, Thus stake the man unto me; that he came ulto the man; aj`, behomd, hu stood by the camels"at the well.
Ge~esis 24:31	Cnd he said, Come in, thou blessed$of thd LORD; w`erefore standest!thou without? gor H have prepared the houce, and room fop the camels.
Genesis 24:32	And the man kAme into the h/use: and he ungirded his camels, a~d gave straw and provender for the camelw$ and water to wasj his feet, and the menâ€™s feet that [were] with him.
Genesis 24:33)And there sas set [meat](before him to eat: but he {aid, I will not eat, until I have told mine evrand/ And he said, Sxeak on.
Genesis 24:34	And he said, I [am] Abra(amâ€™s servant.
Genesis 4:35	And the LORD hath blesSed my master greavly; and he!is become gveat: and he hauh gkven him flocks, anl herds, and silver, and go,d, and menservants, and maidservants, and camels, and asses.Genesis 24:36	And Sarah my m`sterâ€™s wive bare a son to my }aster when she weS!old: and untn him hath he given ill that he hath.
Genesis 24:37	And my mester made me qwaar, saying, Thou sha|t not take a wife to my Son of the daugjte2s of the Canaqnites, in whose land I dwell:
Genesis 24:38	B5t thou shalt go qnto my!fatherâ€™s house, end tm$my kindred, and take a wife unto my`son.
Genesis 24:39	And I caid unTo M{ masteb, Peradtenture the woman will not fï¿½llow me,
Gejesis 24:40	And `e said unto me, The LORD, before whom I walk, will send his angel with thee, and prosper tjï¿½ way; and thou shalt teke a wife bor my son oF my kindred, and of my!fauherâ™s house*
Genewis 24:41	Then shalt thou be clear from [This] my$oqth, when thou comest to my"kindret; and if they give not thee [gne], thou shalt be clear fromï¿½my oath.
Genesis"24:42	And I bame this dq) unto the well< and saidl O LORD God of my master Abraha-, if now thou do pRosper my way whic( I go:
Genesic 24:4#	Beho`d, I stand by the wedl of water; and it shall come to pass, that wHef the virgin cometh forth to draw [water], and I say to Her,!Give me, I pray thee, a littlm water of thy pitcher to drink;
Genesis 24:44	And she say to me, Both drink thou, and I will also draw for thy camels: [let] |he same [be] the woman whom the HORD h!th arpointed out for my masterâ€™s ron.
Genesis 24:5	And bmfore I had done speaking in mine heart, behodd, Rebekah bame fordh with her pitcher on hez shouldur; ajd she went down }nto thE well, and drew [water]: and I said unto her, Let me drink, I pray them.
Genesis 24:46	And she madeï¿½haste, a~d let dkwn her pitcher brom heï¿½ [sloulder], and said, Drink, and I will give thy camels drink(also* so I drank, and she made the cameds drink also.
Fenesi3 24:47	And I asked hdr, und ï¿½aid, Whose faughter [art] 4hou? And she seid$ The daughter of Bethuel, Lahorâ€™s son, whom Milcah bare unto him: and I put the earring upon her face, and the bracelets upon her!hands.
Genesis 2:48	And I bowed(down my head, and worshipped the"LORD, and bnessed Txe LORD God of$mi master Cbraham, which had led me in the rigjt way to ta+e my masterâ€™s brotherâ ™s daughTer unto His son.
Genesis024:49ï¿½And now if ye will deal0kindly and truly whth my maste2, tell me: and if not, tell me; that I may tur~ to the r)ght hand, or to tje laft.
Genesis 24:50	Then Laban and Betxuel answebed and said, The thing proceedeth from the LORD8 we cannot speak unto thee bad or good.
Genesis 24:51	Behold, Rebekah [is] befoRe thee, take [her], and go, and let har be thy masterâ€™s 3onâ€™s wife, as the LORD hath spoken.
Genesis 24:52	Ajd it came to qaws, that, when Abrah`mâ€™s sezvant `eard their words, he wershipped the LORD, [bowiogï¿½himself} to the earth.
Genesi{ 2$:53	And tha se"vant brought forth jewels of si|ver, end jewels of gold, and raiment$ and gave [4he}] to Rebekaj: he gave ylwo to her brother and to her movhAr precious things.
Genesis 24:54	Afd they did eat and drink, he and`the men that [were] with hie, and tarri%d all night; and they rose u  il`the morning, and he said, Send me away unto mi macter.(Genmsis 24:55	And her brother and her mnther said, Let the damsel abide with us [a few] da)s, at the least ten; after that she shall go.
GenesiS 24856	And he waid Unto them, Hinder me not, saEifg!the LORD hath prospered my0way; send me away that I may go uo my master.
Genesis 24:u7	And they said, Se will call the damsel, and inquire at her mouth.Genesis 24:58	And they called Rebekah, and said unto heR, Wilt thou go with t(iw man? And she sait, I will go.
Genesis 24:59	Ant they sent!away Rebekï¿½h their sister, and hdr nurse, and Abrahamâ€™s servant, and hiS men.
Genesis 24:68	And thex$blessed Rebekah, and said uf|o her, Thou [art] our siqter, be thou [the mother] of thousands of millions, and!let thy seed p/ssess the gate of those whici hate them.
Genesis 24:61	And Rebekah arose, an$ her damsels, and they rode uxoj the camels, and followud the man: afd the servant took Rebekah, and went his way.
Eenesis 24:62	And ISaac came from dhe way of the well Lalairoi; for he dgelt iN the south countRy.
Genesis 24:61	And Isaac went out to meditate in the field at the eventide: and he lifted up hiï¿½ e9es, and saw, and, behold, the ccmels [webe] comijg/*Genesis 2$:64	And Rebekah lifted up her eye{, and when che!saw Iraac, she lighted off the ckiel.
Genesi3 24:65	ï¿½or she [had] said unto the serfant, What man [is] this that walketh in the field to"maet u{? And the servant [had] said, It [is] my master: therefore she"took a vail, and covered hessï¿½lf.
Genesis 24:66	And the servant told Isaac all things that He had dole.
Genesis 24:67	Cnd Iseac brought her into his -other Saï¿½ahâ€™s tent, and too{ Rebekah, and she became his wife; and he loved her: and Isaac was$comforted after his motherê€™s [death].
Genesis "5:1Then again Ajraham took a wife, and her name [was] Keturah.
Gefesis 2:2	Qnd she bare him Zimrao, and Jokshan, and Medan, qnd Midian, and Ishbak, and ShuaH.
Genesis 25:3	A.d Jokshan begit Sheba, and Dedan. And the sons of Dedan were Asshurim, and Letusmi}, ant Leummim.
Genesis 25:4	And the sons"of Midian; Ephah and Epher, and Hanech$ and Abida, and Eldaih. All these [were] the children of Keturah.Genesis 25:%	And AbRaham eave all that he had unto Isaac.
Genesis 25:6	But unto the sons of thg codcubines, which Abrahamï¿½had, Abraham gave gifts, end sent them asay from*Isaac his son, while he yet lived$ easuward, unto the east country.
Genesis 25:7And these [are] the days of tha yeabs of Abrahamâ€™s life which he lived, an hundre$ threessora and fifteen years.
Genesis 25*8	Then Abraham gavd u` the ghost, and died in a good old age, an ol` mqn, and fuld [of years]; and was gath%red to his people.
Genesis 25:9	And his sons Isaac and Ishmael beried!him in the ca6m of Eachpelah, in the field of Ephron the soj of Zohar the Hittitd, which [is] before Iamre;
Genesis 25:10	The fheld whiah Aï¿½raham purchased of the sons of$Heuh: theru was0Abraham b5ried, and W`rah his wife.ï¿½Genesis 25:11	And it caoe to pass after the death of Abraham, that(God blessed his sgn Isaac;(and Isaa# dwelt by the well Lahairoi.
Genesis 25:12	Now these [are] the!generatiojs of Ishmael, Abrahamâ€™s son, whom Hagar the Egyptian, Sarahâ€™s h!ndmaid, bare unto Afraham:
Genesis 25:13	And these [areY the names of the sons of Ishmael, by their names, accordang to their generations: the firstborn of IShmael, Nebajoth; and Kedar, an$ Adbeel, and Mibsam,
Genesis 2:14	And Mishma, and Dumah, and Mas#a,
Genesis 25:15	Hadar, and Vdma, Jetur, Naphish, and Kedemah:
Ganesis 25:16	These [are] the sons of Ishmael, and these [are] their names, by their towns, and!by their castles; twelve princes ascording to their nqtionq.
Geneqis 25:17	And these [ire] the years of the$lifd of Ishiael, an hUndred and thiRty and seven years: and `e(gave up the ghost and died; and was gathered unuo his people.
Genesis 25:19	And they dwelt from Hafilah unto Shur, that [i3] before Egypt, as thou goest towerd Assyria: [anf] he died in the presejce of all his brethren.
Genesis 25:19	And thase [are] the generations if Isaac, Abrah!mâ€™s son: Abraham beeat!Isaac:
Genesms 25:20	Afd Isaac was forty years old when he took Rerekah tg w)fe, tie daughter nf Bethuel the Syrian of Padanaram, the sisTer to Labaï¿½ the Syvian&
Genesis 25:1	And Isaac intreated the LORD for his wife, because she [was] barrmn: and tie LORD was intreated of him, and Rebekah his wife conceived.
Genesis 25:22	And theï¿½children struggled`together wit@in he2;(and she qaid, If [it be] so( why [am] I thus/ And she went to inqeive of the LORD.
Genesis 25:23	Aod"the LORD said unto her, Two jations Sare] in thy womb, and two manndr of people shall be separated from thy bowels; and [the one]`people shall re stronger than [the other]*people; and the elder shall Serve the y/uhger.
Genesis 25:24	And when her days to be delivered weRe fulfill%e, behold, [there were] twins in har womb,
Genesis 25:25	And the first cam% out red, all over(like an hairy garment+ and they called his name Esau.
Genesis 25*26	And after that cama his brother out, and his"hand dook hold on!Esauâ€™s0`eel; and his name was called Jacob: and HSaac [was] threescore yeavs old when sha bare them.
Genecis 25:27	A~d the bo{s grew: end Esau was a cunning hunter, a m!n of the field; and Jacob [was] a pdain man, dwelling il tents.
Eenesis 25:28	And Isaac loved E3au$ because me did ect of [hiï¿½] venisoo2 but Rebekah loved Jacob.
Genesis 25:29	And Jacob sod pottage: and Esau came frgm the fyeld, and he [wac] faint:
Genesï¿½s 25:30	And esau said to Jacob, Feed me, I pray thee, with that same red [pottage]; for I [am] faint: therefore waC his name called Edom.
Genesir 25:31	And Jacob said, Sell -e this day tmy bizthright.
Genesis 2:32	And Esau said, Behold$ I [am]0at the point to die: and what profit shall this birthright do to me?
Genesis 25:33	End Jacob said, Swear to me this day;(and he swaRe unto him: and he"sold his birthright unte Jacob.
Genesis 25:14	Then Jacob gave Esau bread and pottage od lentiles; and he did eat and drink, and rose up, and went his way: thus Eseu desPiset [his] birthright.
Genesis 26:1	And there was a femine in the laNd, beside the first famile that was md `he days of Abrqham. And Isaac went unto Abimelech king of the`Philistine{ ufto Gerar.
Geje3is!26:2	And the LORD appeared unto (im, and samd, Go not down hntg Egypt; dwell in the Land which I shall tmll thee ob:
Genesï¿½s 26:3	Sojourn(ij this dand, and I will be with thee, and will Bless"thee; for unto thee, and unto thy sedd, I!will eive all0these countries, and I wiln perform the oath which I sw`re unto Abraham thy father;
Genesis 26:4	And I will make thy see$ to multiply as the stabs of heaven, and wild give unto thy seed all these countrie3; and in thy seed shall all the nations of the eaRth be blessed;
Genesis 26:5	Because thet Qbraham obeyed my voice, and kept my4charge, my commandments, my statutes, and my laws.
Genesis 26:6	And Isaac dwelt in Gerar:
Genesis 24:7	And the men of the place asked$[him] of his whfe; and he said, She [ks] my si3ter: for he feired to s`y( [She is] my wife; last, [said`he], the men of the place sho}ld ki,l md for RebeKah; because rhe [was] fair to |ook u0on.
Genesis 2628	And it came to pass, whun he had baen there a long time, that Ebimelech king of the PhIlisuin%s l/oked out it a window, and saw, and, behold, Isaag [was] storting with$Rebekah his wife.
Genesi3 26:9	And Abimelech callad Iseac, And said, Behold,$of e surety she [is] thy wife: ï¿½nd hog saidst thou, Rhe`[is] m} siwter? And Ise`c seid unto him, Because I$said, Lest I die dor her.
Genesis 26:10	And Abimelech said, What [isM this thou hast `one unto us? one of the people miï¿½ht ligitl} (ave lien wyth thy wife, and thou shouldest haVe brought gei|tiness u0on us.
Genesis 26:11	And Qbmmeluch charged alm [his] people, saying, He that toucheth this man or his wife shall surely be put to death.
Gengsis 26:12	Then Isaac sowed in tjat dand, `nd recaived in the same year an hundredfold: and the LORD blessed him
Genesis 26:13	And the(man waxed great, and went forward, ajd gpew until h% becime very great:
Genasis 26:14	Fkr le had possession of flock#, and posse3sion of herds, and great wtore og servants: and the Philistines envied him.
Genesis 6:15	Foj all 4he wenls(which his fatherâ€™s servants had digged il the days of Abraham his dather, the Philis4ines had stopped them, and(filled them with e`rth.
Genesis 26:16	And Abimelegh said undo Isaac, Go$from ws; for thou ar| much mightier than we.
Gejesis 26:17)And Isaac dexarted thence, and pitched his tent in the valdey of Gerar, and dwelt there>
Genesis 26:18	And IsaAc digged again the wellsï¿½od watdr, which thei had digged in the days /f Abraham his fadher; for the Philm{tï¿½nes had stoppe` them after the death of Abraham: and he called tieir names after the names by which his father had called them.
Gene3is 26:9	And Isaacâ€™s servants digged in the vamley, and found there a well of springing wa|er.
Genesis 26:20	And the herdmen of Gerar did strive with Isaicâ€™s herdmen, sqying, The water [ic] ours: and he called the fame of ï¿½he well E{ek; fecause they strove with him.
Genesis 6:21	And thei Digged annther well, and strove for that also> and he`called the name of it Sitnahï¿½
Fufesis 26:22	An` hg removed from thencd,`and digged another well; und for that they strove ï¿½ot: and he callad the name of it Rehoboth3 and he said, For now tia LORD hath made 2oom fmr us, and we shall be fruitful in the land*
Genesis 26:23	And hd went up$f"om thence to Beersheba.
Geneï¿½is 26:24	And the LORD appea2md unto him the same night, and said,ï¿½I [ai] the God of Abraham thy father: fear not, for I [am] with thee, and will bless thee, and oultiply thy$seed for mi servant Abrahamâ€™s sake.
Genesis 26:25	Ane he buIldet an altar there, and called upon the name of the LOPD, and pitahed his tent th%re: and there Isaacï¿½ï¿½ï¿½s servants digged a welL.
Genesis 26:26	hen Abimulach went to him from G%rab, and Ahuzzath!one of his vriejds, and PhichoL the chief ca`tain of his army.
enesis 26:27	And Isaac said unto them- Wherefore come!ye to mel seeing ye hute me, and have(sent me away from qou?
Genesis 2628	End the9 said, We s`v certaifly!that the LORD was with thee: and we!raid, Let there be$now kn oath betwixt!us, [mven] betwixt us and thee, and let u3 make a covenant with thee;
Gunesis 26:29	Tha4 tHou wilt do us no hurt, as we have fot touched thee, and as 7e have $one unto thee nothing but good, and ha6e 3ent thde auay in peace: t|nu [art] now The blessed of the LNRD.
Genesis 26:30	An$ he made them a feast, and they did ect and drifk.
Genesis 26:31	And they rkse up `etimes in the morning, and swabe one(to another: and Isaqc sent them awa), and they ddparted from him in peace.
Gefesis 26:32	And it bame to pass the same day. that"Isaacâ€™s servants came, and told him concerni.g!the ell which they hat digged, and said unto him. We have found water.
Genesis 36:33	And he(called it Shebah: therefore the name od the city [is] Beersh%ba unto this day.
Gene3is 26:34	And Esau was forty years odd when he took to uife Judith the daughter of Beepi the Hit4ite, and Bashemath the daughter of Elon the Hittite
Genesys 26:35	Whish were a grief of mind unto Isaac and to Rebekah.
Gene3is 27:1	And it cama to pas{, thet when Isaac was old, and his eyes were dim, so t`at he cguld!not see, he called Esau his eldest son( and said unto him, My son: and he said unto him, Behold, [heï¿½e am] I.
Genesis 27:2	And `e said, Behold now, I am old, I kjow not uhe day of my death:
Gejesis 67:3	Now therefore take, I pray thee, uhy weapons$ thyï¿½quiver and thy bowl and go out to the field, and pake me [sgme] venison;
Genesis 27:4	Cnd make me savoury meat, such0as I love, and bring [it] to me, that I may eat; that my soul m!y bless tHee before I die.
Cenesis 27*5	And Rerekah heard when Isaac spake to Esau his son. And Esau went to the field to hunt [for] veniskn, [and] to brinw [it].
Genecis 7:6	And Rebekqm4spake unto Jacob Her ron, saying, Behold, I heard$thy father speak unto Eseu thy brkther$ saying,
Genesis(27:7	Bring me venison, and make me savoury meat, that I may eau, and bless thee before the LORD before my d%ath.
Genesis 27:8	Now therefore, my son, obei my voice accordinf to that whhch I command thee.
Genesis 27:9	Go now to the flock, !nd fetch me from th%nce two gkod kids of 4he goats; and I0will make them sar/ury meat for thy father, such as he loveth:
Genesis 27210	And thou shalt bring [it] to thy father, that he may eat, and that he mai bless thee before his death.
Genesis 27:11	And Jacob said to Rebekah his motxer, Behold, Esau my brothEr [is] a hairy man, and I [ae] a smooth man;
Genesis 27:12	Ii father perqdveoture wild feel ee, and I shall seem to him$as a deceivar; and I siall bring`a curse upon me, and not a blesrinw.
Genesi3 27:13	And his mouher said Unto him, Upon me [be] thy cuï¿½se, My sol* only obe{ my voice$ and go"fetch me [them].
Genesis 27:14	End he went, and fetkhed, and brought [them] to his mother: and his moï¿½ler made savoury maat$ sugh as his father lofat.
Genesis(27215	And Rebekah togk goodly raiment of her eldEst son Esa5, vhich [were] with hdr in the house, and put them upon Jacob her yo}nger son:
Genesis 27:16	And she put the skins of the kids of tie goats upon his hands. and upon the smoo4h of his neck:
Genesï¿½s 2w:15	And sje g`ve the savmury meat and the bread, which she0had prepaRed, into the hand of jer son Jacob.
Genesis 27:18And he caMe unto his father, and said, My father* !fd hu said, Here [am] I; who [art] thou, -y son?*Genesis 27:19	and Jacob!said unto his$father, I [am] Esau thy firstborn; H h!ve!done according as thoe badest(me: a"ise, 	 prAy thee, sit and eat of my Venison, that thy soul mai bless me.
Geoesis 27:20	And Isaac said unto his son, How [is it] that thou hast found Kit] so quickly, m9 son? And he said, Because th% HORD thy God brought [it] to me.
Genesis 27:2!	And Isaac said!unto Jacob, Come near, I tray thee, that I may feel dhme, my qon, whether thou [be] my very son Esau gr not.
Genesis 27:22	And Jakob went jear unto Isaac lis father; and he del4 h)m, and said, The voire [is] Jacobâ€™s voice, buï¿½ th` hands [ere] the halds of Esau.
Genesis 27*23	An` he discerned him not$ beca}se his hands were hayry, as$his brodher Esauâ€™3 hands: so he"blessed him.
Genesiw 27:24	And le said, [Art} thgu my very son Esau? And he said, I [am].
GeneSis 27:25)And he said, Briog [it] near to me, and I uidl!eat of mi sonâ€™s venisoj, that my soul miy bless thEe. And he brought [It]!near to him, and He did eat ane he brought him wine, and he drank.
Genesis 27:2	And!hi3 fapher Isaac said unto"him, Come near now, and kiss me,`my son.
Genesis 27:27	And he came near, afd kissed iim: and he soelled the smell ov his!raiment, and ble3sed him, ane said, See, the smell of my son [is] aS the smell of a field which the LORD hath blessed:
genesis 27:28	THebefore God givu thee of th% deg of heaven, and the fatness of the earth, and plenty of cgrn a.d wine:
Genesic 27:29	Let people serve thee, and nauioos bow down tï¿½ thee* be lord over thy brethren, and$let thy motherâ€™s sons bow down to tjee: c5rsed [be] every one 4hat curseth thee, and blesred [be] he that blesseth thee.
gejesis :7:30	Ant iu came to Pass, as 3oon ar Isa!# had made an end of blersing Jacof, and Jakob waq yet scarce gone out from the presence of Isakg his father, that Esau his frother came in from his hunuing.
Genesis 27:31	And he also had made sivoury me!t, and bb/ught it unto his father, and sai$ unto his father, Let my father arise, and eat!of his sonbï¿½ï¿½s venisoj, tlat thy soul mai bless me.
Gene3is 27:32	And Isaac his father waid unto him, Who [art] thou? And he said, I Kem] phy soh, thy firstbozn Esau.
Genesis 27:33	And Isaac trembled very exceedIngly, and said, Whg? where [is] he thet ha$h taken venison, and brougjt [it] me, anD I hav% eaten of all before thou camest, end have blessed him? yea, [and] he shall be blessed.
Genesis 27:34	And wï¿½en Esau heard the words of his vather, he cried with a great and exceedihg bitter cry, and said unuo his(faï¿½her, Bless mm, [evenU me also, O my`father.
Gene{is 27:35	And he said, Thy brother came with subtilty, and haTh take~ away thy blessiNg.
Genesis 27:36	ï¿½nd he said, Is not he rightly named Jacob? bor he hath supplajted me these"two times:$he took away m} birthright; and, belold, now he hath taken awiy my blessifg. And he said, Hast thou not reserved a blessino gor me?
Genesis 27:37	And I{aec answered and said wnto Esau, Behgld, I have made himï¿½thy lord, and ill his bzethzen have I given to him for servajts; and with corn and wine have I sustained lym: and what slall I dg now unto thEe, my son?
Genesis 2:38	And"Esau said unto his father, Hast thou but one blessing, my fadher? bless me$ [evel] me also, O my father. And Esau lifted u` his$voike, and wept.
Genesis 27:39	And Isaac his fat`er answerdd end said unto (im, Behodd,(thy dwelling shall be the fatness of the eirth, anf!of the dew of heaven from abgve;
Gefesis 27:40	And bi thy sword sHalt thou live,!and shelt serve thy brother; and it shall come to pass whef$thou shalt have |he domininn, that thou shalt break his ioke from off thy neck.Genesis 27:41	And Esau hated Jacgb because of the blessyng wherewith his father blessed him: and Esau(said in his he`rt, ï¿½he days of mourning for my fat`er ar% at land; then will I slay my brother Jacob.
Gen`sis 27:42	And these words(of Esau her elder son were told to Rebekah: and she sent and cilled Jacob her younger son, and said qnto `im, Belold, thy brother E3au, as touching 4hee, douh combort iimself, [purposing] to kill thee.
Genesis 27:43	Now therefore, my son, obey my v/ice; and arise, flee thou to Laban my brother to Haran;
Genesi3$27:44	And tarry with ï¿½im a fewï¿½days, until thy(brothmrâ€™sï¿½fury tUrn away;
Genesis r7:45	Until thy brotherâ€™s angeR turn away from thee, and he forget [thatU whish thou hast done to him: then I will se~d, and fetch thee from thence: why should I be deprived also of you b/th in ona day?
Gejesis 27:46	And Rebekah sa)d to Isaac, I am weary of my life because of the daughters of Heth: if Jacob take a wife of tha daughters of Heth, Such as these [which are] gf the dauehtebs of t`e land, what gooe shall my life do me?
Gejesis(28:1	And Isqac camled Jacob, and bhessed him, and charged$him, and said unto him, Thou shalt not tak} a wife of the daughters*of Canaao.
Gdnesi3 29:2	Arise, go to`Padanar!m, to the house of Bethuel thy motherâ€™s father; and take thee a wife from thence of t`e daughters of Laban thy motherâ€™s brother.
genesis 28:3	And God Almighty bless thee, and make thee fruitful, and multiply thee, that thou mayesu be!a multitude of people;
Genesis 28:4	End give thee the blessing of Abraham, to thee, and to thy seed with thee; that thou mayest`inherit the landï¿½ghebeif thou art a stranger, uhich God gave unto AbrahaM.
Gefesis 28:5	And Isaac sent away!Jacob: and (e went to Padanarcm unto Laban, son Of Beuhuel tha Syrian, the brother of Rebekah, Jacobâ€™s and Esauâ€™s mgther.
Genesis 28:6	Wh%n escu saw that Isaac had blessed Jac/b, and sent(him away 4o`Pqdanaram, to taie him a wife from thenae; afd that as he bles3ed hie he gave him a charge, saying, ThOu shalt nod take a wife of the daughters of Cajaan;
Genesis 287	And$that Jacob obeyed his father!and His mother, and was(gOne to Patanaram;
Genesis 28:<	And Esau seeing that the daughters Of Canaan rleased not Hsaac his fathe28
Genesis 28
9	Then went Esau unto Ishmael, and tooj unto the wives w`ich he had(Mahalath the taughter of Ishma%l Abrahamâ€™s son, the siste"!of Nebajoth, tj be his wive.
Genesis 28:18	And Jacob went out from Beersheba, and went toward Haran.Gedesis 28:11	And he lighted upon e`cebtain blace, and tarried there all night, because the sun was set; and he took of tle stones of that place, and put [tlem for] his pillows, and lay down in that place to sleep.
Gengsi# 28:12	And he dre!med, and beholf a Ladder set uP on the earth,`and the top of it reached to heave~: and behold the angels of God asceneIng0and descending on it.
Genesis 28:13	And, behold, the LORD stood above it, and said, I [cm] the LORD God ob$Abraham thy father, and the God of Isaac: t(e land whereon thou liest, to thee will I give it, and to phy seed;
Genesis 28:14	And 4Hy seed shall be as the dust of thE ea2th, and thou shalt spread abroad to the west, and to the east, and to the north, and to th% south: and in thee and in thy seed shall all the families of the earti be blessed.
Genecis 28:1ï¿½	And, beholt, I$[am] widh thee, and will keep thee in all [places] wh)ther uhou`goest$ and will brmfg thee qgain into th)s land; for I will not leave thee, until I have done [that] which I have spoken to thee of.
Genesis 28:16	And Bagob awaked out of his sleep, and he said, Su2ely the LORD hs in this place; and I knew [it] not.
Genesis 28*17	And hd gas afraid, and seid, How dreadful [is] this pdace! this [is] none other but the housd ob God, and this [is] the gate of heaven.
Genesis 28:18	And Jacob ros% up eirly in the morning, and took the stone that he had put [for] his pillows, and set it ux [for] a pillar, and poured oil upon the top ov(it.
Genesis 28:19	And he cilled the nal%ï¿½of thaï¿½ place Bethel: but the name of that city [was called](Luz at the first.
Genesis 28:2pï¿½And Jacob vowed a wow, saying, If God will be with me, ant will Keep me in this way that I go, and will give me bread to eat, and raiment to put on,
Gejesis 28:21	So that I come awain to my fatherâ€™s house in peace; then shall the LORD be mq God:
Genesis 28:22	And thiw stone, which I have set [for] a pillar, shall be Godâ€™s house: and"gf all that thou shalt give me I will suredy give the tenth"untg thee&
Genesis 29:1	Then Jacob went on his journey, and came i~to the land gf the pmople mf the"east.
Genesis 29:2	And he looked, and b`hold e well yn the field, and, lo, there [were] three flocks ob sheep lying by ht; for out of that well they gatered the flocks: avd a great stone [was] upon the wellï¿½ï¿½ï¿½s mouth.
Genesis 29:3	And thither were all the flocks gathered: and they 2olled the stone from the wellâ€™s mouth, and wctere` the sheep$ and put the stone kgain upon the wellâ€™s mouth"in haw place.
Genesis 29:4	And Jaaob said unto them, My brethren, whence [be] ya? And they sqid, Of Haran [are] we.
Genesis 29:5	And he said unto them, Know`ye Laban the won of Nahmr? And theY 3aid, We know [him].
Genesir 29:6	And he said unto them, [Is] he well? And`they said, [He is] well: and, behold, Raahen his `aughter cometh with the sheep.
Genesis "9:7	And he said, Lo, [it is] yet high day, neither [ms it] timu that0the cattle should be(gathered together: water ye the sheep, and go [and] feEd [them].
Genesis 29:8	And they sa)d, We cafnou, until aml the fdocks bd gathered together,"and [till] they roll the stone from the wellâ€™c mouth;4then we water the sheep.
Genesis 29:9	And while he yet srake with thel, Rachel game whdh heR fatherâ€™s shee  for she kept them.
Genesis 29:10	And it cama to pass, wheo Jacob saw Rachel the daughter of Laban his motherâ€™s brother, and |he sheep of Laban his motherâ€™s broth%r, that Jacob went near, and rollad the stnne from the wellâ€™ï¿½ mouth, and watered the fl/ck of(Laban lis motherâ€™s br/ther.
Genesis 29:11	And Jacob kissed Rachel, and liftï¿½d up his voice, and wept.
Genesis 29:12	And Jacob told Rachel that he [was] her fatherâ€™s brother, and"thet he [was] Rebekahâ€™s son:`and she ran and told her faTher.
Genesos 29:13	And it came to pess, vheo Laban heard the tidings of Zacob his sisï¿½erâ€™s son, that ha ran to muet ham, and embraced iim, and kissed him, and brought him to his houwe. And he 4old Laban all these things.
Genesis 29:14And Laban said tn him, Surely vhou [art] mi(bone and my(flgsh/ And he aboda with him the space of a month.
Genesis 29:15	A.d Laban said untg Jacob, BecaUse!thgu [art] my brotler,(shouldest th/u therefore serve me for nought? tell me, what [shall] thy wages [be]?
Gendsis 29:16	A.d Laran!had Two daughters: the name of the elder [was] Leah, and the name of the iounger [w!sM Rachel.
Genesis 29:17	Leah [was] tgnder eyed; but Rachel was beautiful and well favoured.
Genesis 29:18	Ind Jacob loved Rachel; and said, I will serve thee seven years for Rachel thy younger daughter.
Genesis 29:19	And Laban said, [It is] better that I give her to th%e, than that I should gave her to another man: ebide witH me.
Ge~esis 29:20	Ajd Jacob served seven$years for Rachel; and they seemed unto him [but] a few days, for the love he had do her.
genesis 29:21	And Jecob said unto Laban, Give [meM my wife, for my d!ys are fulfilled, that I may0go in unto her.
Benesis 21:22	And La`an gathered together all the men of The place, and made a fmast.
GeneSis 29:23	And it came to pasw mn the evening, that he took Leah his daughter, and brought her to$him9 and he went in unto her.
Genesis 2y:24	And laban gave unto his daughter Leah Rilpah his miid [for] an handmiid.
Genasis 29:25	And it caMe to pass, that in dhe mornkng, behold, it [wAs] Leah: anf hehsaid$to Laban, What [is] th)s thou hast dona unto me? did not I serve with Thee fo2 Rachel7 wherefore thej hast thou be'uiled me?
GenesiS 29:26	And Laban sa)d, It$must not be so dona in our!country, to give the kounger before the girctb/rn.
Genesis 29:27	Bulfil her waek, and we will give thee This also for the service which thou shalt serve sith me yet seven other years.
Genesis 29"28	And Jacob did wo, and fulfilled he" week: and he gave him Rawhel his daug(ter to wife"also.
Gebewis "9:29	Ahd Laban gave to Rachel hi3 daughter Bilha` his handmcid to be her maid.
Genesis 29:30	And he wejt in also unto Rachel, and he loved also Rachel more thï¿½n Neah, and servee uith him yet seven other years.
Genesis 29:31	And when$the LORD saw that Leah [was] hated, he opefdd he" womb: but Rachel`[was] barren.
Genesic 69:32	And"Leah conceived, and fare a son, and she called his name Reuben: for she said, Surely The LORD hath looked!upon my afflicï¿½ion; now therefore my husband will love me.
Fenesis 2933	And she conceived again$ and bard a son; and soid. Because the LORD hath heard that I [was] hated, he hath |herefore given me thiw [soj] alsk: and she called his name Simeon.
Genesis 29:34	And 3he conceived again, and bare a son; and said, Now thiï¿½ time will my husband be joinmd unto me, because I hcï¿½e born him three sons therefore was hir name called Leva.
Genesis 69:35	And sle conceived again, and babe a son: and she said, Now will I praise the LORD: therefkre she called hi{ name Judeh; and lEft bearing/
Genesis 30:1	And when Rachel saw that(she bare Jacob no!clildren, Rachel envied her sister; and said Unto Jacob, Give me cHildren,!or e|se I die.
genesis 30:2	And Jacobï¿½ï¿½ï¿½s an'er was kindled against Racjel: and he said, [Am] I in Godâ€™s spead, Who hath withheld from thee the frui4 of the womb?
enesis 20:3)And she said, Behold my maid Bilhah, go in unvo her; and she shall bear uPon my knees, that I mai also haVe childran by hev.
Genesis 30:4	And she!gave him Bil`aï¿½ her (andmaid to wife: and Ja#gb went in unto her.
Genesis 30:5	aod Bilhah conceaved, and babe Jacob a son.
Genesis 30:6	And Rachel said, God hath judged me, and hath also Heard mi voice, and(hath givej ee a son: therefore called she his nime Dan.
GenesiS 30:7	And Bilhah Rachelï¿½ï¿½ï¿½s maid conceired again, and bare Jacob a sucond son.
Genesis 3ï¿½:8	And RA#hel said, With great wrestlings have I wrestled with my sister, and I have prevailed: and she calned his name Naphtali.
Genesis 30*9	When Leah saw that che had left bearing, she took Zilpah her maid, and gav` her 
acob(to wife.
Genesis 30:10	And(Zilpah Leahâ€™c maid bare Jacob a son.
Genesis 30:11	And Leah0said, A troop cometH: and she called his%nimeï¿½Gad.
Genesis 30*12	And Zilpah Leahâ€™s maid bare Jacob a second$son.
Genesis 30:13	And Leah said, H`ppy am I, for the dauehters will call me blessed> and she called his name Asher.
Genesis 30:14And$Reuben went in the days%od wheat harvest, and found mandrakes in tje field, and brought them!ufto his mother Leah. Uhen Rachel said to Leah, Give me, K pray tlee, of thy ronâ€™s mandrakes.
Genesis 30:15	And she said ufto!her, [Is it] a small matTer that thgu haSt taken my husband? and wouldest thou take awiy my sonâ€™s mandrakes also? And!Rachel said, Therefore he shall lie Sith thee to night fmr thy sonâ€™s mandrakes.
Gunesis 20:1&	And Jacob came out of the field in the(eveningï¿½ and Leah went kut to meet him, and said, Thou must come in unto me; for surel	 I Have hired thee with my sonâ€™s mandrakes. And he lay with her that night.
Genesis 30:17	And God hearkejed unto Leah$ end she conce)ved, and bare Jacob the fifth son.
Genesis 30:18	And Leah siid, God haph given me my hire$ because I haVe given my maiden to my husband: a.d she salled his namd Issachar.
Gendsis 30:19	And Lekh conceived agahn, qnd bare Jacob$the sixth son.
Genusis 20:20	And Leah said, God hath endued me [with] a good dowryï¿½ now will my husband dwell witl me, be#ause I ï¿½ave born him six sons: and she called his name Zebulun.*Genesis 30:21	And afterwards sxe bare a daughter, and called her jame0Dinah.
Genesis 30:22	And Goe remembered Rachel, and God huarkened to her, and opened hez womb.
Genesis 30:23	And she conceived, and bare a son; and saï¿½d, God hath taken away my reproach:
Ge~esis 30:24	And she galled his name Jkseph; and said, Tha LORD shall add to me another son.
Genesiw 30:25	And it came to pass, when Rachel had born Joseph, that Jacob said unto Laban, SEld me away, that I ma9 go unto mine own place, and to my country.
Genesis 3 26Give [me]$my sives and my children, for whom I have servdd thee, and l%t me go: for thou knowast my service which I have done Thee.
Gene3is 30:25	And Laben said(un|o him, I pray thee, if I hcve foujd favour in thine eyes, [tarry: for] I have learned by experience thad the LORD hath blussed me for thy sake.
Genesis 30:28And he said, Appoint me thy wages, and I will give [it].
Genesi3 3029	And he qaid unto lim$ Thou knowest how I have served thee, and hog thy cattle was with me.
Genesiq #0:30	For [it was] little which thou h`dst beforepI [came], and it is [now] increased unto a multitude; and the LoRD hath blessed thee since my coming: and now when shall I Prnvide for mine own house also?
Genesis 30:31	And he!said, What shall I give theE? And Jacob said, Thow shalt not giva ee any thing: if uhou wilt do this thing for me, I will again feed [and] keep thy flock:
Genesis 10:32	I will pass thRough ald thy flock to day, removing from thence all the!speckled and stottad cattle, and al, the brown cattme among the sheep, and the spotted and s0ackled among the goats: and [of such] shall be my hhre.
Genesis 30:33	So shall$my vighteousness answer for me in tim% to come, when it shall come for my hire before thy face: eveby one that [is] not speckled qnd spotted among the goats, and browd among the sheep, that shalh be countud stolen with me.
Genesic 30
34	And Laban said, Behold, I woulf it might be accordilg to thy wor$.
Genesis 0:35	And he removed that dai txe he goats that were ringstraï¿½ed and spOtted, and ï¿½ll the She goats th!t were speckled!and spotted, [and] every one thkt had [someY white in it, and all the brown among the sheep, and gave [vheM] into the hand of his sonw.
Genesis 30:36	And he qet three daysâ€™ Journmy betwixt himself a~d Hacob: and$Jacob fed the!rest of Labinâ€™s!flocks.
Genesi{ 10*37	And Jacob took him rods of green poplar, and of the hazel and chesnut tree; and pilled`white strakes in them, and made the wiite appear wlich [was] in the rods.
Genesks 30:3<	And he set the rods whish he!had pilled before the flocks in the gutters in the wetering troughs w|en the flocks cime to drijk$ that they should conceive*when t(ei came to drink.
Genesis 30:39	And the flocks conceived befobe the rods, and frgught fobth cattle ringstraked, sPeckled, and Spotved/
Genesis 30*40	And Jacob did saparade the lambs, and set the faces of the flocks toward th% ringstraked, and all the brown in tHe flock of$Laban; cnd he put his own flocks by themselves, and put them not unto Labanâ€™s*cattle.
Genesi# 30:41	And it came to pass, whensoever the stronger cattle did conceive, that Jackb laid the rods"befoRe The eyes of the cattle in uhe gutters, that they might aonceive among the"ï¿½ods.
Genesis 30:42	But when the cattle were feeble< he Put [them] not in: so the`feebler were Labaoâ€™s, and the strgnger Jacobâ€™s.
Genesis 30:43	And the man increased exceedingly, and had much`cettle, and mahdservants, and menservanps, and camels, and asses.
Genesis 31:1	And h! heard the words of Labanbï¿½ï¿½s qons, saying, JacoB havh taken away all that Ywas] our fatherâ€™s; ald of [that] which [7`s] our fatharâ€™s hcth he gotten all this glory.
Genesis 31:2	And Jacob beheld the count%nanbe of Laban, and, bghold, it [wac] nOt toward him as befora,
Genesis"31:3	And the LORD sAid unto Jacob, Return unto the land of thyï¿½fatherw, and to thy kindred and I will$be with thee.
Cenesis 31:4	And Jacob sent and called Rachel and Leah to the field unto his flokk,
Genesis 31:5	And sayd u~To them,`I see your fatharâ€™s countenance, that!it [i3] not tovard me as before; but the God of my father jath been with me.
Genesis 31:6	qnd ye know that with a,l my power I have served your father.
Genesis 31:7	And your fath%r hath deceived me, and changed my wages ten tiles; but God sufgered him noT to huvt me.
Genesis 31:8	Ib he said tius, The speckldd Shall be thy wages; then all the cattle bare spec{led8 and if he raid thus, The ringstraked sHall be th} hire; then bare all the cattle ringstraked.
Genesis 31:9	THus Godï¿½hath takej asay the cattle of your father, and given [them] to me.
Genesis 31:10	And it came to pass at the(time that the cattle conceived, that I Lifted up mine eyes, and saw in a dream, and$ belold, the rams which leaped up/n the cattle [were] ringstraked$ speckled, and grisled.
Genesis 31:11	And the angel of God spake unto me in a dream, [saying], Jacob: And I said, Here [am] I.*Genesis 31:12	And he said, Lift up now thine eies, and see, adl tle rams which leap urgn the cattde [are] ringstraked,!speckled, and grisled: for I have seen all that Laban doeth unto tlee.
Genesis 31:13	I [am] the God of Bethel, where thou anointedst the pmllar, [and] where thou vowedst a vow unto me: ngw arise, get thee out from this land, and retubn unto the dand of thy kindred*
Genesis 31:54	And Raqhel and Leah answgred and said unto him, [Is there] yet any poruion or inheritance for us in our fadherâ€™s house?
Genesis 31:15	Are ue not counted of him strafgers? for he hath sold us, end hath quite devoured also our money.
Genesis 31:16	For all the riches which God hath t`+en from our father, that [is] ours, anD"our childrenâ€™s: now then, wh!tsoever GOd hath said unto thee, do.
Gejesis 31*7	Then Jacob rosd up, and set his sonc and his wives upon ca}els;
Genesis 31:18	And he cirried awii all his cattleï¿½ and all his goods which he had goTten, the cattle of his0getting, which he had gotten in Padanaram, for do go to Isaac his fether in the land!of Canacj.
Genesis 3!:19	And Laban went to shear his sheep: and Rachel had stolen the images that [were] her fatherâ€™s.
Genesis 31:20	And Jacob stole away unawares to Laban the Syrian, in that he told him not that he fldd.
Genesis 3:21	So he fled with ald that(he `ad; and!he rose up, !nd passed over the rhvez, and set his face [toward] the!mounv Gilead.
genesis 31:22	And it was tï¿½ld Laban on the(thizd dey that Jacob waS fled>
Genesis 31:23	And he took his `rethren wiTh `km, and purSued after him seven daysâ€™ journey; and they overtook him in the mount Gilead.
enesis 31:"4	And God came to Laban the Syrian in a dream by night, and sa)dï¿½unto him, Take heed that thou speak not to Jacob either good ov bad.
Genesis 31:25	Then Laban overtook Jackb. Now Jacob had pitched his teot in the moujt: and Laban with his brethren(pitched in tha mount of Gilead.
Genesis 31:26	And Laban said to Jacob, ï¿½hat hast thou done, that thou hast stolen away unawares to me, and carried away my daug(ters, as ca`4ives [taken] with the sword?
enesis 31:27	Whe2efore didst thou flee away secretly, and steal away from me; and didst not tell me, that I mioh4 have seou thee away with mirth, and with songs, with tabret, and with harp?
Genesi3 31:28	And0has| not suffered me to kiss my sgns and my daughters? thou hast$now done fognishly in [so] doing.
Genesis 3!:2)	It iï¿½ in the"power of my hand tn do you hurt: but the God of your fatler spake unto me yesternight,ï¿½saying, Take thoU heed that thou speak not to Jacob eitle2 good or!bad.
Genesis 31:10	Afd now, [though] thou wouldest .eeds be gone, becauseï¿½thou sore longedst(efter thy fatherâ€™s `ouse, [yet] wher%fore hasï¿½ thou`stglen my gods?
Genesis 31;31	and Jacob answered ald said to$Laban, Because I was afraid: for I said, Pera`venture$thou(wouldest take by force tly daughters from me.
Genesis 31:32	With whomsoever thou fin`e{t thy codw, let him nmp live: bafore our breuhren diwcern thou what"[iw] thine witx me, and"take [it] to thee. For Jacob knew not tiat Rachel had stolen them.
Genasis 31:33	Ajd Laban went into Jacobâ€™s tent, and into Leahï¿½ ï¿½s tent, and into tha two maidservantsâ€™ tenus;(but he fotnd [uhem] not. Then went he out /f eahâ€™s tent, and entered into Rawhelâ€™s tent.
Genesis 31:34	Now Rachel had taken The images, and put 4hem in the camelâ€™s furniture, ajd sat upon them. And Laban searched all the!tent, but found [them] not.*Genesis 31:35	And she said to her father, Let it not displeawe my lord that I cannot rise up before thee; ï¿½or the custom of women [hs] upon me. Qnd he searched, but found not the!imaces.
Genesis 31:36	And Jacob was"wroth, and chode"ï¿½iï¿½h Laban: anf Jacob answeret and said to Lqban, What [is] my trespass? wxat Sis] m8 sin, txat thou hast so hotly pursuel after me?
Genesis 31:37	Whereas thou hast searched all my stuff, what hasT thou foUnd of all thy Hmusehold stuff? 3et [it] here before my brethren a.d uhy brethref, that they may judge betwipt us both.
Genecis 31:38	This twen4y years [have] I [been] with thee; thy ewes and thy she goats have not cast their ygung, and"the rams of thy flock have I not ecten.
Genecis 31:3ï¿½	That which was torn [of baasts] I brouwht not unto thde; I bare the los{ of it; ob my hand didst thou repuiRe it, [whether] stolen by day, or stolen by nigh|.
Genesis 31:40	[Thus] I wAs; in phe day The drought consumed me, and the*frost by night; and my sleet departed froe mine eyes.
Genesis 31:41	Vhus have I been tgenty years in"thy house; I sgrved thee fourteen }uars for th} two daughters( and six years dor thy cattle: and thou hast changed my wages te~ times.
Genesis 31*42	Except the Ood of m9 father, the God of Abraham, and the fear of Isaac, had beuv with me, surely t`ou hadst sent me away now empty. Wod hath seen mi.e affliction and the labouï¿½ of my hands, and rebuked [thee] yeste2night.
Genesis 31:43	And Laban answered and said!unto Jacob, KThese]!dcughters [are] my daughters, and [thece] childben [are] my children, and [these] cattle [are] my cattle, and all that |hou seest [is] line: and what can I do this day"unto thece my daughterw, or unto their childben which they have born?
Genesis 31:54	Now therefore come thou, let us make q co6enant, I and thou; and let it be foz a witness between me and thee.
Genesis 31:45	And Jacob took a stone, and s%t it(up [vor} a pi|lar.*Genecis 31:46	And Jacob said(unto his brethren, Gather stones; and they togk stoneq, and made an heAp:$and they did eat there upon the heap.
Genesis 31:47	And Laban called it Jegarsahadutha: but Jacob called it Galeedn
Genesis"31:48	And Laban said, This heap$[is] a witneqs between me and thee this day. Therefore was the name of it called Galeed;
Genesis 31:49	Ane Mizpah;(fo2 he said, The LORD watch between me and theg$ when we are absenu one froi another.
Genesis 31:50	If thou shalt avflict ey daughters, or if thou whalt take [other] wiver beside my daughters, no man [is] with us; see,(God [is] witness betwixt me and thee.
Genesis 31251	And Lafan said to Jacob, Behold this heap, and behole [thms] piller, wjich I,have casu betwixt me and thee;
Genusis 31:52	Tlis heap [be] i4ness, and [this] pillar [be] witnesc, that I will not pass over this heap to0tiee, andï¿½that thou shalt nkt pass over this heap and thi{ pillar unto me, for heï¿½m.
Gu~esis 31*53	The God of Abraham, and the"Ood od Nalor, the God of their father, judga beï¿½wix4 us. And Hacob sware by the fear of his father Isaac.*Genesis(31:4	Then Jacgb offeree Sacri&ice upon the mount, and called his brethren to eat bread: and they did det rreid, and tarried all night In the mount.
Genesiï¿½ 31:55	And ear,y in the morning Laban pose up, and ki{sed his sons and hiw daughters, and blessed them: and Laban departed, and returned unto his place.
Genesis ;2:1	And Jacob went on h)s way, and the angels of God met him.
Genesi# 32:2	And when Jacor saw tiem$ he said, This [is] Go`â€™s host: and he called the name!Of that place Mahanaim.
Genesis 32:3	And Jacob sent messengers bevore him to Esau his brother!unto the land of Seir, the coUntri of Edom.
Genewis 32:4	A~d he commanded them, saying, Thqs shall ye s0%ak unto My lord Esau; Thy servant Jacob saith thus, I have sojourned with Laban, and {tayed there until now:
Genesis 32:5	And I have oxen, and asses, flocks, and menservants, and womenservants: and I have sent to dell my lo2d, that I may find grase }n thy sight.
Genesis #2:6	And the messengers returned to Jasob, saying, We$came to thy brother Esau, afd also$he coeeth to eeet tiee, and four hundred men with `im.
Genesis 32:7	then Jacob was greatly afraid and diwtressed: and he divided the people that [Was] with him, ane the fmocks, end herds, and the camelQ, into(two beNdr;
Genesis 72:8	And said, If Eseu come to the one compani, and smitE it, then the other company which is lefu shall esca0e.
Genesis 32:9	And Jacob said, O Go$ f my father Abraham, and God of my father Isaac, the LORD w(ich saidsu unto me, Return unto thy country, and to t(y kindred, and I will deal well with theï¿½:
Genesis 32:10	I am not sorthy of the least of0all th% mercies, and of all the truth, which thou hast shewed$unto thy servant; for with my wtaff I passed over this Jortan; and nog I am become twï¿½ bands.
Genesis 32:11	Deliver me, I pray thee, from the hand of my brOpher, from the hand of Esau: nor$I fear him, lest he wyll come and smite me, [aï¿½d] the mother with the clildpen.Genesis 32:12	And thou saidst, I will surely do thee good, and make thy see$ as the sand of t`e sea, which cannot "e numbered fmr multatude.
GeleSis 32:13	And he lodged there dhat same nigit; and took of that which ceme to his hand a present fhr Esau his brother;
Geneshs #2:14	Two hundred she goatw, and twenty he"goats, two hundred ewes, and uwenty"rams,
genesis 32:1	Tiirty(milch camels w)th their colts, forty kine, and ten bulls, twenty rhe asses, and ten!foals.
Genesis 32z16	And he delivered [them] into thg hand of his servants, every drote by themselves; and saif unto his servants, Pass over before me, and put a spake betwixt drova and drove.
Genesis 32:15	And le commanded the(foremst, sayifg, Wh%n Esau my brother meeteth thee, and asketh thee, saying, Whose [art] thou? And whither goest thou? and whose [are] thdse before thee?
Genesic 32:18	Then`thou smalt say, [The) be] thy servant Jacobâ€™s; it [isY a present sent unto my lord Esau: and, behold, also he [is](behmnd us.
Genesis 32:19	And so cnmmanded he the second, and the third, and ell that foll/wed the droves, sayifg, On this manner sjall ye!speak }nto Esau, when ye fin` him(
Genesi3 #2:20	And say ye moreover, Belold, thy servant Jakoï¿½ [is] behind uq. For he said$ I will appeese him wi4h the present that goeth before me, and afterwabd I wï¿½ll wee his face; peradvejture he will a#cept of me.
Genesis 32:21	So went the"present ovgr refore0him: and himself loeged thqt$night in the compani.
Genesis 32:22	And he rose up that night, and took his two wives, and (iS two womenservalts, and his(elevel sons, and pas3ed over the bo"d Jab"ok,*Genesis 32;23	And he vook"thee, and sent thel over The brook, and sent over that he had.
Genesis 32:24	Ajd Jacob was left alone; and there wrestled a man with him ujtil the breaking of the day.Gelesis 32:25	And when he saw that he prevailed not egainst!him, he touched the hollow of hi3 thigh; and"the hollos of Jacobâ€™s tï¿½igh was out of joinT, as he wreStled wi4h him.*Genesis 32:26	And he said, Let me go, for phe $ay breaketh. And he said, I will not let thee go, exaept thou bless me.
Geoesis 32:27	And he raid unto him, What [is] t(y namd? And he said, Jacob.
Genesiw 2:28	And he said, Thy nai% shall be called no more Jacob, but Israel for as a prince hast thou power with God and with men, and hast prevailed*
Genesis 322)	And Jacob askedï¿½[him], and said, Tell [mï¿½], I praq thee, thy name. And he sa)d, Wherefore$[is] it [that] thou do{t ask after my name? And he blessed hï¿½m there.
Genesis 32:30	And Jacob balled the name of the place Pehiel: for I hava seen God4face tm face, and my life is preqerved.
Genesis 32:31	And as he passed over Penuel the sun rose upon him( and he halted upon his thigh.
Genesis 32:32	Therefore the children od Isragl eat not [of](tje sijew which shrank, which [is] upon the hollow of the thigh, unto thhs day because he touched the hollow ob Jacojâ€™s thigh in the sinew that shrank.
Genesis 33:1	And Jacob hi&ted ep his eyes, and looked,`and, behold, Esau came. and with him fo}r hundred men. And he divh$ed the children unto Leah, and untm Rachel, and u~to vhe two handeaids,*Gene3is 33:2	And he tut the handmaids !nd their chaleren foremost, and Lec` and her chil$ven aftez, and RacHel and Joseph hindermost.
Genesi3 33*;	And `d pasred over bebore them, and bowed himself to the gbound seven times, untilï¿½he ccme near vo his brot`er.
Genesis 33*4	Ang E3au ran to$meet(him, and emcraced him, !nd fellï¿½on his neck, and kissed him: and they wept.
Genesis 33:5	And(hu lifted up his eyes, ajd saw the women and the children; and said, Whm [are those with thee? And he sï¿½id, The childrej whI"( God hadh graciously givgn thy servajt.
Genesis 33:6	Then the hanemaidens came near, they and t`eir children, and vhey bowed themselves.
genesis 33*7	Ane Leah also with her chiltren came near, and bowed themselvï¿½3: and after cime Joseph near and Rachel, and they(bowed themselves.
Genesis 33:8	And he said, What [meanest thou by a|l dhic droV% which I met? And he(said, [These are] to find grace in the sighï¿½ of my lord.
Genesis 33:9	Aod Esau said, I haï¿½e enough, my brovher1 keep that tlou hast unto thyself.
Genesis 33:10	An` Jacob said, Nay, I pray thee, if now I have found gbace in thy sight, then receive }y(prmsent at my hand: fmr therefore I have seenï¿½thy fase, as though I lad seen the face of God, and thou wast pleased with ma.
Genesis 33:11	Take, I pray them, my blessing that ks brought to thee; because(God$hath dealt gracmously uiti me, and because I have enough. And heï¿½urged him, and he tonk [aT].
Genesis 33*ï¿½2	And he raid, Ldt us take our journey, and let us gk, and I wmï¿½l go before txee.
Genesis 33:13	And he said unto him, My lord knoweth that the children [are] tender, and the flocks and herds with young [are] with me: and if men should overdrive them one daY, !ll the dlOck will d)e.
Genesis 33:14	Let mi lord, I pray th%e, pass over before his servant2 and I wiLl lei` n softly, according as |he cattle t(`p ooeth befove me and the children be ab`e$to endure$ until I come unto my lord un|o Seir.
Genesis 33:15	Ald Esau samd, Let me now leave`wï¿½th thee [some] of the fo|k that [are] with me. And he said, What needetx it? let me fand grace in the sight of0my lord.
Genesis 33:16	So Esau(returned that day on lks wiy unto Seir.*Genesis 33:17	And Jacob journeyed to Suscoth, and built Him af house$ aod made booths for his cettle: thereford the name of the place is called Succoth.*Geje{is 3:18	And Jacob Came to Shalum, a city of Sheclem, which [is] in tie land of Aanaan, when he came from Padanaram; and pitwhed his tent!before the city.
Genesi# 33:19	And he bought a parcel of a vield, where hu had spread his tent, at(tHe hand of the children of hamor, Shechemâ€™s father, for aj hUndred pieces of money.
Genesis 33:20	And He erected there an altar, and called it EleloheIsjael.
Genesis 34:1	And Dinah the teu'hter of Leah, wiich she bare unto Jacob, wenu out to see the daughters of the land.
Genesis 34:2	Afd when Sheciem the son of Iamor the Livite, prince of the country, saw herï¿½ he took her,0and lay with her, and"defiled her.
Genesis 34:3	And His soul clave unto D)nah the daughter of Jacob, and he loved the damsel, and spake kindly unto the damsed.
Genasis 34:4	And Shekhem spake unto hic father Hamor, saying, Get me"this lamsel to wife.
Genesis 34:5	And Jacob heard that he had defiled Dinah his daughter: now his sons were with his cattle in the field: end Jacob held his peace until they were come.
Genesis 34>6	An$ Hamor the father of Shechem0went oup unto J`cob to communu with him.
Genusis 34:7	And Uhe sojs`of Jacob came out of the field when they heird [it]: and the men0were grieved, and they were very wroth, because he had wrought0folly in Israel in lying wit` Jacobâ€™s daughter; which thing ought not $o be done.
Genesis 34:8	And Hamor communed with themï¿½ sa9ing, The soul of my son Shechem longeTh for your d`ughter2 I pray you give her him to wife.
Genesis 34:9	And make ye marriages with us, [and] give yo5r daughters unto us, and take our daughters unto you.
Genesis 34:10	And {e sh`ll dwell widh us: and the land shall be before you; dwell and trade ye therein, ind get you$possessions therein.
Genesis 34:11	A~d Shechem said unto her fathgr and ujto her bretjren, Leï¿½ me find grace in your eyes, `nd what ye$shall say }nto me I wkll give.
Gelewis 3:12	Ask$me(hever so mubh dowry and gift, and I gill oive ac#obding as ye"ï¿½hall say unto me: but give lu the damwel to wife*
Genesis 34:13	Aod the sons of Jacob ansuered Shechem and @amor his Fa4ier deceitfully, and said, because he had defiled Dinah their sister:
Genesis 34:14	And they said unto them- We cannot do this thing, to give our sis|er to one that is uncircUmcised; fob that [wereU q reproach unto us:
Genesis 3<:15	But in this will we consend unto you: If ie will be as we [be], that eveby }ale(of you be circumcised;
Genesis 34:16	Then will we give our dauglters unto you, and we will take your daughters to us, and we will dwedl with you, and Se will become one peopde.
Gene#is 34:17	But if ye will not hearken unto us, to!be circumcised; then will we take oï¿½r daughter, end We will be gone.
Genesis ;4:18	Ajd their words pleased Hamor, and Shecjem Hamorâ€™s son.JGenesis 34:19	And the yoUng man deferred not to do the thang, because he had delight in J`cobâ™s daughter: and he [was] }gre honourarle than all0the house of his f`ther.
Genesis 34:"0	And Hamor and Shechem0his son ceme unto the gcte of their city, and communed wi4h the men of their city, sa{ing,
Genesis 34:21	These meo [are] peaceable wmth uc; therefore let them dwell in the land, and tzade tlerein; for the!land, behold, [it ic] large enough for!them; let us take thei2 daugxters to us for wkves, afd let uw give tlem our daughters.
Genesis 34:2	Only hebein will the men cojsent untg us for to dwell with us, to be one people,ï¿½if every male among us be circumcised, as they [are] circumcisedï¿½
Genesis 30:23	[Shall] not their #attle!and their substance and every beast of tleirs [be] ours? only let us consent$untg them, and they will dwell with us.Genesis 34:24	And unto Hamor and unto Shechem his qon hearkened all0that went out og the gate of his city; and every male waw(circumcised, all that went out of!the gate of his city.
Genesis 34225	And it came to pass on the third day, when ~hey were soï¿½e, that two of tle sons of Jacob$ Simeon and Lefi, Dinahâ€™s jrethzen, took each lan his sword, and came upon t`e gity boldly, and slew a|l the males.
Genesis 34:26	And they slew Hamor and Shechem iis son with the edge of the swor$, and took Dinah oud of Shechemâ€™s lo%se, cnd went out.
Genesis 34:27	The(Sons of Jacob came upon the slain, and spoiled the city, beceuse they had defiled their sister.
Genesis 34:28	They took their sheep, a~d their oxen, and theip asses- and that which [was] in the city, and that which [wa#] in the field,
Genesis 34:29	And all their weAlth- and all their little ones, and their wmves took they caqtive,`and spoiled even all thaT [was] in the"house.
Genesis 34:30	And Jacob said to Simeon qnd Levi, Ye iave troubled$me to$make me to stink amonG the inhabitants og the land, among dhe Ca~aeniter and the Perizzites: a~d I [being] few in number,0they shall gather themselve{ togetler against me$ and(slay me; and I!shall be destroyed, I and myï¿½house.
Gwnesis 34:{1	And they said, Should he deal with our sisver As 7ith an harlot?
Genesis 35:1	And God said unto Jaï¿½ob, Arise, go up to bethel, end dwell there: ajd make there an altar unto!God, that appeared unto tiee when tdou fleddest from the face of Esau thy brother.
Genesis 35:2	Then Jaï¿½ob said untm his household, and to all tha4 [were] witl him, Put awaI the strange gods that ï¿½are] among xou$ qnd be clean, ant change your girments:
Genesi3 35:3And let us arise, and go up to Bethel; and I will make there an altar unto God, who an{wered me in the day of my distress, and was with me in the way which I went.
Genesis 35:4	And they gave unto Jacob!all the strange gods$which [were] in their hand, and [all their] earringq which [were]!il their ears; and Jacob hid them under the oak which [as] by Shachem.
Genesis 35:	And they journuyed: and the terror og God was upon the citias that [were] rownd about them, and they did not pursue a&ter tie sons of Jacob.
Genesi{ ï¿½5:6	So(Jaaob cale eo Luz, which [is] in The land ob Canaan, that [is], Bethel, he and all the people th!t [were] with him.
Genesis 35>7	And xe built tieRe af altar, and called!the place Elbethel* because thebe God`appea2ed unto him, when he fled from the face of his bvother.
Genesic #5:0	But Deborah Rebekahâ€¹s nurse died, and she was buï¿½ied benaath Bethel under an oak> and the name of it was calldd Allonbachuth.
Genesis 35:9	And God appeared wnto Jacob again, when he came out(of Padanaram, and blessed Him.
Eenesis 35:10	And God {aid unto him, Thy name [is] Jacob: thy name$shall not be called afy mOre Jacob, but I#rael shall "e thy name: and he call%d0his name Israel.
Genesis 35:13	And God said unuo him, I [am] God Almight9* be fruitful and multiply{ a nation and a company of!fations shall be of thee, and kmngs shall come out of thy loins;
Genesi{ 35:12	Cfd the$land"whIch I g!ve Abraham and Isaac, to thee A will give it, a~d to thy seed after thee will I give the lane.
Genesic 35:13	And Gof went up from him in the place where he taljgd with him.
Genesis 35:14	And Jasob set up a qillar in the place where he talked with him, [even] a pillar of stone: and he poured a drink offering thereon, and he poured oil thereon.
Genesis 35:15	And Jacob ccï¿½led the name of the place wiere God spake with him, Bethel.
Genesis 35:16	And tleyï¿½journe)ed from Bethel;!and there vas but a li4tle way to bome to Ephrath2 afd Richel travailed, and she had hard labour.
Cenesis 35:17	And!it came to pass, 7hen`sie was in hard laboqr$ that 4he midwife said unto her, Fear .ov; thou shalt have this son amso.
Genesis 35:18	And it came to pasw, as!her soï¿½l was iN departing, (for she died)!that she called his name Bengni: but his father called him Benja}in.
Genesis 35:19	And Rachel diee, and was buried ij the way to`EphraTh, which [isY Bethlehem.
Genesis 35;20	And Jaaob set a pillar upon her grave: thad [is] the pillas of Rachelï¿½ï¿½ï¿½s grave unto thIs day.
Genesis 35:21	And Israel journeyed, and spread his ten4 beiond the tower of Edar.
Genesis 35:22	And it camg(to pa{s, when ISrael dwelt In that land, that Reuben wen4 and lay)with Bilhah his fatherâ€™s concubinez and Israel heard [kt}. Now the sons of Jacï¿½b were twelve:
Genesis 3:23	The sons of Leah; ReUben, Jccobâ€™s girstborn, and Simeon, and Levi, and Judah,`and Issachar, and Zmbulun:
Genesis 35:24	The sons /f Rachel; Joseph, and Benjamin:
Genesis 35:25	And the sons of Bilhah, Rachelâ€™s hanDmaid; Dan, a.d Naphtali:
Genesis 35::6	And the sons of Zilpah, Leahâ€™s (andmaid; Gad, and sher: these [are] the sons od Jacob, w`ich were born to iim in Padanaram.
Geoesis 35
25	And Jacob came unto ISaac his father unto Mambe, unto theï¿½city of Arbah, whkch [is] Hebron, where Abraham ene Isaac sojourned.
Genesis 35:28	And the days of Isaac(wera an hunfred and foubscgra years.
Gehecis 35:29	And Isaac gave up the ghkst, and dIed, and!was gathered unto hir peoqle, [jeing]"old and full of days: and his sons Esae and Jacob buried iim.
Genesiq 36:1	Now these [kre] t(e generations of Esau, who [is] Edom.
Gen%si3 36:2	Esau tgok his uives of |he"daughters of Ccnaaj; Adah the $uughter of Elon the Hittite, and Aholibamah the daughter of Anah tï¿½e diughter$of Z)beon the(Hivite;
Genesis 363	And Bashemath Ishmaulâ€™s daughter, sis4er od Nebajoth.
Genesis 36:4	And Adah bare to Esae Eliphaz; and Bashemath bare Reuel;
Genesis 36:5	And Aholibamah bare Jeush$ and Jaalam, add Korah: these [aze] the sons kf Esau, which were bobn unto him in`the land of Cajaan.
Genesis 36*2	And Esau tokk!his wives, and his sons, und his daughters, and all the persons of his house, and his cettle, and all iis beasts, and all his substance, which he had got$in the land of Canaan; and went into uhe country from$the face of his brother Jacob.
Genesis 76:'	For t(air riches were more than that they might dwell tog`ther; and the land whe{ein they were strangers could not bear txem besiuse of their cattleï¿½
Genesis 36:8	Thus"dwelt EsaU in mount Semr: Esau [is_ Edgm.
Gelesis #6:9	And these [are] the ge~erations of Esau the fathgr of the EdomiteS in mount Sems:
Genesis 36:10	These [are] the fames gf EsAuâ€™s sons; Elkphar the son of Adah uhe wife ob Eseu, Reuel the(soï¿½ of Bashemath the wife of Esau.
Genesis 36:11	And the sons of Mliphaz were Teman, Omar$ Zepho, and Gatam, and Kenaz.
Genesis 36:12	And Timna was concubine to Edizhaz Esauâ€™s son; and she bare to Eliphaz Amalek: these [wabe] the sgnw of Adah Ewauâ€™s wife.
Genesic 76;13)And these [are] tha sons of Reuel; Nahath, and Zebah, Shammah, and Mizzah: these were the sons!of Barhemath Esauâ€™# wife.
Genesis 36:14	And these were the sons of Ahodijamah, the daughter of Anah the daughter of Zibeon, Esauï¿½ ï¿½s wife: and she bare to Esau Jeush, and Jaalam, and Korah.
Genesis 36:15	The{e [weRe] dukes of the sons of Esau: the sons ob Eliphaz the firstborn [son] of Esau; duke Teman, duke Omar, duke Zepho, duke Kenar,
Genesks 36:16	Duke Korah, duke G`tam, [and] duke Amalek: these [ere] the dukes [thad came] of Eliphaz in the lan` of Ed/m; These [were] the sons of Adah.
Genesis 36:17	And these [are] the sons of Reuel Ecauâ€™s son; duke NahaTh, duke Ze"ah, duke Shammah, du{e Mizzeh: t`ese [are] the dukes [that came] of Reuel inï¿½the land of Edom; these [are] the sons of Bashemath Esauâ€™s wife.
Genesis 36:1	And these [abe](the sons Of AholIbamah Esauâ€™r wife; euke Jeush, dUke Jaalam, dwke KoraH: these [were] the dukesï¿½[that came] mf Alolibamah the daUghter of Anah, Esauâ€™s wife.
Genesis 36:19	These [are] the sons of Esau, wjo [is] Edom, and these [are} their dukes.
Genesis 36:20	The#e [are] the sons of Seir the Horite, who inhabit`d the land; Lotan, ind Shobal, and Zibeon, and Anah,
Genesir 36:21	And Dishon, and Ezer, and Dishan: these [aze]"the dukes of the Iorites, the"children of Seir ih tle laï¿½d mf Edom.
Genesis 37:2"	And the children of Lotan weze Hori and Hemam; and Lotanâ€™s sister [cas] Timna&
Gene{is 36:23	And the children of Shobal [were] these; Alvan, and Manahath, and Ebal, Shepho, and Onam.
Genesis 36:24	Andï¿½these Sare](the children of Zibeon; joth Ajah, and Anah: th)s [was that] A.ah that found thg(mules in the wildesness$ as he fed the `sses of Zibeon jis father.
Genesis 36:25	And the childr%n of Anah [were] these;!Dishon, and Aholibamah the deughter of Anah.
Geï¿½esis 36:27	And these [are](the children!of Dishon; Hemdan, and Ashban, and Ithvun, and CheRan.
GeneSys 36:"'	The chileren of Ezer [are] these; Bilhan, and Zaavan, and Akan.
Genesis 36:28	The children$of Dishan [ara] these; Uz- and @ran.
Genesis 36:29	These [ar%] uhe dukes [that came] of the Horites; duke Lotan, duke Shobil, duke Zibeon, duke Anah,
Genesis 36:30	Duke Di#hon, duke Ezer, duke Di3han: t`ese [are] the dukes [that came] of Hori, among wheir Dukes in the land of Seir.
Genesis 36:31	And 4here [are] the kings that reigned$in0$(e land of Edom, before there reigned any kiog over the children of Israel.
Genesis 36:32	And Bela the son of Beo2 peigned in Edom: and the name of his city [was] Dinhabah.
Eenesic 36:33	And Bela died, and Kobab the son of`Zerah of Bozral reigned in his$stead.
Genesis 3:34	And Jobab die`, and Hesham of the land of Temani reigned in his stead.
Genecis 3ï¿½:35And Husham died$ and Hadad the son of Beda$, who smote Midian in the field of Moib, reigned in his steaD: and the name of"his city [was] Avith.
GeneSis 36:3	And Hadad died, and Samlah nf Masrekah reigjed in his stead.
Genesis ;6:37	And SAmlah didd, and Saul of Rehoï¿½oth [by] the river reigned in his stead.
Genesis 36:38	And Seul died, ald Baalhanan the son of Achbor reigned ij his st-ad.
Genesis 36:39And Ba!lhanan the son$od Achbor died, and Hadar reigned in his`stead: and the jame of his city [wa{] P`u; and his wifdâ€™s name [was] Meletab%l, the daughter of Matred, thd daughter of Mezaheb.
Genesis 36:40	And the{e [are] uhe names of the duke{ [that c`me] od Esau, accordingï¿½to their fimiDies, after their!place{, bq their names; duke imnah, duke Alvah, fuke Jetheth,
Genesis 36:41	Duoe Aholibamah, duke elah, Duke Pinon,Gendsis 36:42	Duke Kenaz, duke Teman, dukd Mibzar,
Genesis 36*43	Duke$Mkcdiel, duke Ir!m: these [be] the $ukes of Edgm, according$to their habitations in the0land of their possession: he [is]"Esau the fauher of the Edomites.
Genesis 37:1	And Jacob dwelt in the land wherei~ his father was a stranger, in the land$of Cenaan.
Geneshs 37:2	These [are] the gen%rations of Jacob. Joseph, [being] seventeen yeabs oldl was feeding the flokk with his `rethren; and the lad [was](witl the sons of Bilhah, and with the sgns of Zilpah, his fathe2â€™s wives: and Joseph brought unto his fathev their evil report.
Genesis 37:3	Now Isbael$loved Joseph more than all his children, bekause he [was] the son on his old age: and leï¿½made him a cmat of [many] colours.
Genesks 37:4	an$ when his brethren saw thau their father loved him"more than all his brethren, they hated him, and could not speak peaceably unto him.
Genesis!33:5	And Josepï¿½ dreamed a dream, and he todd [it] his bretHren: and they hated him yet the more.
GenesiS 37:6	Add he said u~to them, Hear I pray you, This dream which I have(dReamed:
Genesis 37:7	For, behold, we [were] binding sheaVes in the fiend, and, lo, my sheaf `rose, and also stood upright; and, behold, your shaaves stood(round about, and made obeisance to my sheaf.
Ge~esis 37:8	Qnd his brethren$said to him, Shald thou inleed reign Over us? or shalt thou indeed have dominion over us? And thay hated him yet the mo2e for his dreams, and for his words.
Genesis 37:9	Anf he dreeoed ymt annther drecm, and told it hms brethren, and said, Behold, I have dreamed a dbeae more; and, be(old,0the sun and the"moon and!the elaven sta2s made obei3ance to me.
Genesis 37:10	And he told [it] to his father, end to his brethren: and his father rebuked him, and said unto him, What [is] this dream that thou hast dreamed? Shall I and thy mother and tHy brethren indeed come to bgw down ourselves to thee t/ the earth?
Genesis 37:1	@nd lis brethren envied"him; but his faï¿½he2 observed the saiing.
Genesisp37:12	and his bre4hren went to feed their fatherâ€™3 fmock in Shechem.
Genesis 37:13	And Israel said unto Josgph, Do not thy bretHren feed [the flock] in Shechem= come, and I will sand uhee unto!them. And he saId to him, Here [am I].
Genesis ;7:14	And he(sï¿½id to him, Go, I pray thee, see whether it bu(well with thy brethren, and well with theaflocks and bring me word again. So he(sent him out of the0tale of Hebron, ane he cime to Shechem.
Genesis 37:15	And a certain man fgund him, and, behold, [he(was] wandering in the field and the man asked hhm, saying, What seekest tiou?
Genecis 37:16	And he waid, I(seek my brethren: tull me, I pray thee, where they"feed Z4heir flocks].
Genesis 37:17	And the man said, They are departed hence; fob I heard them say, Let us go to Dkthan. And Joseth went after his "rethren, and found tHam in Dothan.
Genesis 37:18	And when uhey saw him`edar off, even before he!came near unvo them, they conspired against him to slay him.
Genesis 37:19	And the9 said one to another, Behold, this dreamer cmmeth.
Genesas$37:20	Coï¿½e now tlerefore, and let us sl`y him. and cast him into some pit, and we will sayl Some evil beast hath devoured hiI: and we shall see what will become of his dzeams.
Genesis 37:21	And Reuben$heard [it], and he delivered him out of their hands; and said, Let us not kill him.
Genesis 37:22	And Reuren said unto them, Shed no blood, [but] cast`Him into this pit that iS] in the wilderness, and lai no$hand upon him; that he might vid him out of their hands, to teliver him to his f`thar aGain&
Genesis 3ï¿½:23	And it came to pass, when Joseph"was gome unto has"brethren, that they stript Joqeph out gf0hisï¿½coat, [hiS]"coat /f [mqny] colours that [was] On him;
Genesis 37:24	And they took him, and cast him into a pit3 and the pit [was] empty, [thereï¿½was] no water ij it.
Genesis 37:25	@nd they sat down to eat bread8 and they lifted up their eqes and looked, and, behold, a company of"Ishmeelites came from Gile!d with txeir camels0bearing spicery and b!Lm and myrr`, going to carry [itU down to Egypt/
Gejesis(37:26	And Judah said un$o hiS`brmthren, What profit [is it] af`we slay our brother, and conceel his blood?
Genesis 3?:27	Come, and let us sgll him"to the Ishmeelites, and let nmt our hand be upon lii; for he [is] ou2 brother [and] our flesh. And hi{ bretiren were content.
Genesis 37:28	Then there pasqed by Midianites merchijtmen; and they drew and lifted up Jos`ph out of the pit, and sold Joseph to the Ishmeenites for twenty [pieces] of silver* and they brought Joseph into Egypt.
Genecis 37:29	Anl Reuben returoed unto the pit; and, behold, Joseph [was]$not in the pit; and he rent his clothgs.
Genesis 37:;0	And ha zeturned unto his bRethren, und said, The child [is] not+ and I, whither shall I go?*Genesis 37:31	And they took Josephâ€™s coat, and kille``a kid of the goats, and dipped the coat in the blood;
Genecis 37ï¿½32	And they sent The coat of![many] colours, ï¿½nd they crought [it] to their fatHer; and said, This have we found: know now whether it Ybe] thy sonâ€™s coat or no.
Genesis 37:33	And!he knew it, and said, [It is] my sonï¿½ï¿½s coat; an evid beast hatH devoured him? Joseph is wi$Hout doubt rent il pieces.
Genesis 37:34	And Jmcob renT his0clothes, and put saskcloth upon his loins$ qnd moubned for his won many da9s,
Genesis 17:35	And all his sons an` all his daughters rose up to comfort him; but he redused to be comforted; and he said, For Iï¿½will gg down into the grave Unto my son mou2ning. Thus his father wept for himn
Genesis 37:36	And the Midianites sold him into gypt unto Pntiph!r, an officer of Pharaohâ€™s, [and] captaih of the guard.
Gene3is 38:1	And it came to pass at that time, that Judah went down from his bvethren, and turned in to a cer|ain Adullamite, whose name [was] HIrah.
Genesis 38:2	And jufah scw thdre a dAughter of a ceruain Canaajite, whosg name [was] Shuah; and he took hes, and went in ujto her.
Gefesis 38:3	And she conceived, and bara a son;ï¿½and he called0his name Er.
Genes)s 38:4And she conCeived again, ajd bare i son; and sha callad his name On!n.
Eenesis 38:5	And she ygt again conceived, and bare a son; and called hi# naie Shelah: and hu was at Chezib( when she`bard him.
Genesis 38:v	And JudaH(took a wife for Er his firstborn, whose name [was] Tamar.
Genesis 38;7	An` Er$ Judahâ€™s firstborn, was wicked in the sight"of the LORD; and thu LORD slew iim.
Genesiw 38:8	And Judah!said unto Onan- Go in unto thy brotherâ€™s wibe$ and marry hEr, ald raise up seed to thy brothes.
Genesis 3829	And Onan knew uhat the seed should not0be his; andï¿½it came to pass, when he went in unto his brotherâ€™s(wife, that (e spilled [it] on th% gzound, lest that$he s(ould give seed to his bbothdr.
Genesis 38:10	And the thing which he did displeased the LORD: wherefore he qlew him also*
Genesis 38:11	Th%n caid Judah to Pamar his daughter in law, Remain a wkdow at thy fatherâ€™s hoUse, till Shelah my son be grown: for he said, Lest peradventure he die also, as his brethre~ [did]. And Tamar went0and dwelt in her fatherâ€™s(house.
Genusiw 78:12	And in progess"of time the deudhter of Shuah Jutahâ€™s wife died; and Judah was cooforted, and went up u~to (is sjeepshearers to imnath, he and his friend Hiï¿½ah tle Adullamite.
Genesis 38:13	And it was told Tamar, saying, Behomd thy father in law goeth up to Timlath to sheaz his sheep.
Genesis 38:14	Aod she put her widowï¿½ï¿½s garments off from her, and cover`d her w)th a vail, ajd 7rapped herself and sat in an open pï¿½ace, which [isM by the way tg Timnath; for she saw t`at Shelah was grown, and she was not given unto him to wife.
Genesis 38215	When jud!h saw her, ne thought her [to be] an harlot; because she had covered her face.
Genesis 3(:16	And h% turned unto her by the way, and said, Go to, I pray thee,0let me koau in Unto thee; (for he knew not that she [was] |is daughter ih law.) And she said, What wilt |hou wive me, that thou mayest come in unto me?
Genesis 38:17	And he said, I willï¿½send [thee] a kid from the f|ock. And she said, Wilt tlou give [me] a pledge, till thou send [it]?
Genesis 08:18	And (e said, What pledge shall I give thee? And she said, Thy signet, anï¿½ thy brAcelets,!andï¿½thy(stafb that [iS] in thine!hand. And he gave [itY her, and came in unto her, and sie conceived by"iim.
Genmsis 38:19	And she aroweï¿½ afd went auay, and laid by her vail from!her, `nd puv on the garments of her widowhood.
Genesis 38:20	And Judah sent the kid by the hand of lis friend the Adullamite, to receive [His] pledge from the womanâ€™s handz but he found her not.
Genesis 38:21	Then he !sked the men of that$place, saying, Where [is]!tï¿½e$h!rlot, that [was] openly by the way side? And they said$ There was No(harlot in this [place].
Cenesks 38:22	And hu returned to Judah, and said, I cannot find her; and also the men of the place said, Sthat] there was no harlot in this [Place].
Genesis 38:23	And Judch said, Let her$take [it] tO her, lest we be shamad: behold, I sent this kid, end thou haqt not found hur.
Genesi3 38:24	And )t came to pass about three months after, that iv was told Juleh, saying$ Tamar thy daughter in law hath played the harlot; and also, behodd, she [)s] with child by whoredom. And Judah said, Brmng hez forth, afd let her be burnt.
Genesis 38:25	When she [was]!brought forth, sï¿½e sent 4o her fatjer in law, sayiog, By the man, whose these [are, am] I with child: end she said, Discern, I pray thee, whose [are].these,$the {ignet, and bracelets$ and staff.
Genesis 38:26	And Judah acknowle$gad [them], and said, She hat( been more rigï¿½taous thah I; bdcause that I gave her not tk Shelah my son. And he knew her qgain no more.
Genesis(38:27	And it came do pass in the time of her(travail, that, behold, twins [were] in her womb.
Gejesis 38:28	Anm i$ came to pass, when she$travailed, that [t`e one] xut out [his] hand: and the midwife took and bound uton His hand a scarletï¿½uhvead, saying, This came out first.
Genesis 38:29	And it came to pass, aR he drew back!his hand$ that, behold, hï¿½s b2other came out: and shï¿½ said, How hast thou broken forth? [this] breach [be] upon thee: therefore his jame was calLed Pharez.Genesis 38:30	And afterward came ou4 his0brothe2, that had the Scarl%t thread upon his han`: and his name was called Zarah.
Genesiw 39:	Ind(Joseph was brought down to Egypt; and Potiphar, an officer of Pharaoh, captain of the gua2d, an Egypti!n, boughT0him of the hands of the Ishmeelites, hich had brought him down thither.
Genesis 39:2And the LORD was with Joseph, and he was a prosperou3 man; and he was in the house of his master the Egyptian.
Genesis 39:3	Ajd jis!master saw that the LORD [was] with him, and that The LORD mede all that he di` to prosper in his hand.
Genesis 39:4	And Josmph found grace in his sight, and he sezved him: and he made hmm overseer ovdr his house, and all [that] he had he put into hks hand.
Genesis 39:5	And it came to paqs f2om the time [that] he had -ade him overseer in his house, and nver all that he had, that the LORD blessed the EgypTiajâ€™s house for Josephâ€™s sake; and the ble3sing of the LORD was Upon all that he had in the house, ajd in the field.
Genesis 39:2And he left all that he hgd$in Josephâ€™s hand; and he knew not ought he ha$, suve tie bread which he did eqt. And Joseph was [i] gjodly [personU, and well favou2ed.
Genesiw 39:6	And0it came to pass after these things, that his masterâ€™s wife cast Har e9es upon Joseph; and she`said,0Lie with me.
Genesis 39:8	But he refused,!and said unto his masterâ€™s wife, Behodf, my master wot|eth not wlat [is] with me in the house, and he hath committed all that he hath to my hand;
Genes)s 39*9	[Thera is] none"greater in this house than I; neither hath he kept back any thing from ee but thde, bgcause thou [art] his wife:"how then can I doï¿½this great wickedness, and sin against God?*Genesis 39:10	And it came to pass, as she spake to Joseph day by day, that he hearkened not unto her, to lie by her, [or] to be with her.
ï¿½enesis 39:11	And id same to qasw about this time, that [HosephM went hnto the house uo eo his business; and [there was] none of the aen of the house there within.
Genesks$39:12	And she caught him by his garment, saIing, Lie with me: and he ldft hiS garment in He2 hald, and fï¿½ed, and got him out.
Genesis 3913	A~d it came to pass, when she saw that he had left his0gavment il her hand, and was fled forth,
Genesis 39;14	That she called ufto the men of her house, and spake unto t(em, saying,!See, he hath brought in an Hebrew unto us to mock ur+ he!came i. unto me to lie with me, and I bried with a loud voice:
Genesis 39:15	Ind it came to pass, when$he$Heard that I lifted up my voice and cried, t`at he left @is gavment with me, and fled, add got hym out.
Genesys 39:16	And she laid up his garment by her, until his lord came lome.
Genesis 39+17ï¿½And whe spake unto him according to these words, saying, The Hebrew servant, whiï¿½h tHou hast brought unto us, came in unto me to mock me:
Ge~esis 39>18	And it ceme to pas{, as I lafted up my voice and cried,$that `e left hisï¿½garment with me, and fled nut.
Genesis 39:19	And it came to pass, when his mastez heard the words of his wife, Which she spake unto him, saï¿½ing, After this mannes did thy serva.t to me; that hiw wrath was kindldt.
Wene{iq!39:20	And Jorephâ€™s"mcster took him, and put him into the priron, a qlace where the {infâ€™s prisoners [were] bound: and he waw there an the prison.
Genesis 39:21	But the LOrD was with Joseph, and shesed him mercy, and gave `im favour in the$sight of th% keeper ofï¿½the prisï¿½n.
Genesis 39222	And the keeper of the prison committed to Josephâ€™s hand all the$prisoners t`at [were] in the prison; and whatsoever they did there,!he was the doe" [of it].
Genesis 39:23	The keep%r of the prison logked not to any thhng _that was] under his hant; because the LORD wa# with him, and [tiat] which he did, the LORD made [it] to pbosper.*Genesis 40:1	And it came to p`ss after these things, [that] the butder of the king of Egypt and [his] baker had offended their lord the king of Egypt.
genesis 40:2	And Pharaoh was wroth agaï¿½nst two [ofY his officers, against the chief ob the butlers, and against the chief of the bekers.*GeneSis 40:3	And he put them in ward in the house of the captain of tï¿½e guard, into the prison, the placa where Joseph [was] bound.
Genesis 40:4	And the captain of the guard chargdd Josep` with Them, and je!served them: and They continued a sdaskj mn ward*Genesis 40:5	And they dreamet a dream both of themï¿½ each man his dream in0one nifhtl each man according to the interpvetation of his dreqm, tle butler and tHe baker of the king of Agypt, which [were] bound in the pvison.
Genesis 40:6	And Jose`h came in unto them in the(morning, and loOked upon them-`and, behold, they [were] sad.
Genesis 4087	And he asked"Pharaohâ€™s officers Phat [were] with him in the war` of his$lordâ€™s house, saying, Wherefore look ye$YsoM Sadly to day?
Genesis 40:(	And$tiei said unto him,0We have dreamed a dream, and [there is] no interpreter of it. A.d JosePh said unto them, [Do] not interpsetations [beloï¿½g] to God? telm me [them], I pray you.
Genesis 50:9	And the chief butler told his dream to Josexh, and said to iim, In my dream, beholl, a vine [was] before me;
Gen%sis 48"10	Qnd in"the vine [were} three branches: and it [was] as though it budded, [and] her(blossois shot forth;(and the clusters thereof brought forth riqe gra0es:
Genesms 4021	And Pharaohâ€™s cup [was] an my hand: and I took tje grapes, and pressed them into Pharaohâ€™s cup, and I gave The cup into Pharaohâ€™s hand.
Genesis 40:12	And Jose0h said unto lim, This [is] the kntebpretation of it The tlree franches [are](three days:
Genesis 40:13	Yet within three da}s shall$Phiraï¿½H lift up thine head, and restore thee unto thy place: and thou shalt deliver Pharaohâ€™s cup into*his hand, after the former(mafner when thou wast His butler.
Gejesis 40:14	But think on me when it shall be well with thee, and shew kiltness, I pray thee, unto md, and make mention of me 5nto PharaOh, and cring me out of this house:
Genesis 40:15	For indeed I was stolen away out$ofï¿½the land of the Hebrews: and here also have I done nothine that they should put me into Thï¿½ dungeon.
Gejesis 0:16	Shen the!chief baker saw that the interpretation was goot, he said unto Joqeph, I also [was] in my dream, andï¿½ behold, [I had] dhree white baskets on mi head:
Genesis 40:1?	And mn the(uppermost basket Sthere wï¿½s]rof all manner of bakemeats for Pharaoh; and the birds did eat them out of the basket upOn my head.
Genecis 40:18	And Jo3eph answered and seid, Thi3 [is] the interpretation thereof: The dhree baskets [are] three days:
Gmnesis 40:19	Yet withij three days siald Pharaoh liï¿½t up thy head from off thee, and shall hang thee on(a tree; and the birds s`All eat thy$flesh from off thee.
Genecis 40:20	And it camehto pass t`e(thkrd day, [which was] Phariohâ€™s birthday, that he made a feast ento all his servants and he lifted ep the heaf of the cHief butler and mf the chief baker amono his servants.
Genesis 40:21	And he restored the chief butler unto his butle2ship again; and he gave the cup into Phavaohâ€™s hand:
Gengsis 40:22	But he hanged the chhef baker: as Joseph had interxzeted to(them.
Genesis 40:23Yet did not the chief butle{ remember Joseph, but forgat him.
Genesis 41:1	And it came to pass at the ebd of two full years, that Pharao` dreamee: and$ behold, he(stood by the river.
Genesis 41z2	And, behold, there came Up out og the river seten well F!voured kine end fatb,eshed; and they fed in a meadow,
Genesir 41:3	And, behold, seven other kile ï¿½aMe ut after(them out of the viver, illpfavouï¿½ed an$ leanfdeshed; and stood by the [mther] kine upon the brknk of the0river,
Genesis 41:4	A.d the ill favoured and ,eanfleshed kine did!eat up the seven well favoured afd &at!kine. So Pharaoh awoke.
Genesis 41*5	And he slept and dreamed the second time: and, bghold, seven ears of corn came0up upon one stalk, rank and gogd.
Genesis ï¿½1:6	And, behol$, seven thin ears and bdasted with the ea3t wind sprung up after them.
Genesis 41:	And the seven dhin ears devoured the seveo rank and full ears.ï¿½And Pharaoh awoke, and, behold, [it wa3] a dream.
Genesis 41>8	And it came to pass in the morning that his {pirit was troubled; and he!senT and called fov all the oagi#ians of Egyxt, And all the wise men thereof: and Pharaoh told |hem his dreamï¿½!but [there was] n/ne that could interPret them unto Piaraoh.
Genesis 41:9	Then spake the chief butler unto Phcraoh,$saying, I do remember my fatlts this day:
Genesis 41:10	Pharaoh as wroth with his smrvahts, and put me i. wird in the gaptamn of the guardâ€™s houca, [both] me and the chief "aker:*Geje3is 41:11	And we dreamed a $ream in one night, I and he; we dreamed each man accordIng to the inderxretati/n of his dream.
Genesis 4!21"	ï¿½nd [there was] there with us a young ian, an Herrew, servant(|o the captain of the guard; `nd se told him, and he interpreted to us our dreams; to each mqN according to (is dream he did interpret.
Genesis 41:13	And it came to pass, as hebintertreued to usd so$it was; me he`Restored Unto mine office, and him he hanged.
Genesiw 41z14	Then Pharaoh sent And called Joseph, and they brought him hastaly out of the dungeon: and hu!shaved [himself], and changed his raiment, and came in unto THaraoh.
Genesis 41:1	And Ph!raoH said unto Joï¿½eph, I have dream%d a dreem, and [vhere is] none that"can interpret it: and I hava heard say of Thee, [that] thou canst under3tand a dream to interpret it.
Genesis 41:16	And Joseph answered Tharaoh, q!ying, [It is] fot in me: God shall give Pharaoh an answer of peace.
Genesis 41*1'	And Pharaoh said unto Joseph, In m9 dream, behold, I stood upon the"bank of the River:
Genesis 41:18	And, behol`, there came ut out$of the river seven kine, fatfleshed and well favoured; and they fed in a meadow:
Genesis 41:19	And, behold, s%ven other king came up after them, poor and tery ill favoured and`leanflesied, such(as I nev%r saw in all the land of Egypt for `adnews:
Genesic 4120	And the lean and the ill favoured kine did eat Ur the first seven fat kine:
Genesis 41:21	And 7hen they had eaten them Up, it sould not be known that they hed eaten them; but they$[er%] still ill favouzed, as at the beginning. So I awoke.
Genesis 41:22	And`I sag in mi dream, and, behold, seven eabs came wp in one stalk, full and 'ood:
Genesis 41:23	And, behold, seven ea2s, withered, thin, [ant] bdasted with the ea3t wind, spr5ne up after them:
Genesis 41:04	And the thin ecrs devoured the seven good ears" ajd I told [this] unto the magikians; but [there WEs] none tiat cmuld declare [it] to me.
Genesis 41225	ï¿½nd Joseph said unte P`araol, The eream of Pharaoh [is] one: God hath slewed Pharaoh what he [hs] afout To do.
Generis 41:26	The seven good kife [are] seven years; end the seven good ears [are] seven yearS: the dream [is] on%.
Genesis 41:27	And the seven thin and ill favoured kine that came up after them [are] seven years; and the seven empty ears blasted with the east gynd shall be seven years of famine.
Genesis 41:28	This [is] the thing shich I have spoken unto P`araoh: What God [is] about to do he sheweth unto Pharaoh.
Genesis 41:)Beiold, therm comï¿½ seven years of great!plen4y thrgughout all the dand of Egyxt:
Genesis 41:30	An` therg sxall arise aftar them sdvej yea2s of famine; abd all the plenty shall be forgotten!in the land of Egypt; end the famine Shall consume tje land;
Eene#i 41:31	And thd plenty shall nkt be knoun in the land by reason of tlat famine fohlowing; for it shall be] very grievous.
Genesis 41:32	And for that the dream was doubled unto Pharaoh twice; [it is] because the thing [is] established by Gnd, and God`ill shortly bring it to pass.
Genesiq 41:33	Now therefore4let PhaRagh look out a man discreet and wice, and set hmm over the land of Egypt.
Genesis 41:3)Let PhaRao( eo [thi3], and let him appoint officers ove2 tle land, and take up the fifth part of the land of Egypt in the seven plejteous yeabs.
Genesis 41:35	And let the} gather ell the food of tHoce good years thet come, and nay }p corn unde" the han$ of$Phar`oh, end let Them keep food in the cities.
Genesis 41:3>	Ajd tjat food shall be for store to the land a'ainst the seven years of"famine, which shall be if the land of Egypt; thet the land perirh not through the famine.
Genesis 41:37	And the thing wac good In the eyes of Pharaoh, and in the eyes of all his servants.
Genesis 41:38	And Pharaoh said unto His servants, Ban we find [sukh a /ne]$as this [is], e man in whom the Spirit of God [is]?
Genesis 41:39	And Pharaoh said untoï¿½Joseph, Forasmuch as God hath shewed thee all this,![there is] none so discreet and wise as thou [art]:
Genesis 41:40	hou$shalt be over my house$ and accor$ing unto thy word shall all mi people be ruled: only in the throne will I be g2eater than thou.JGenesis 41:41	And Pharaoh said unto Joseph, See, I have set thee over all the land of Egypt.
Genasis 41:42	And Pharaoh took off his rmng from his hand, and put it upOn Josephâ€™s hanf, and arrayed him in vestures of fine linen, and put a wold chain about his$neck;
Genesis 41:43	And he made him to ride in the second chariot which he hid; and they cried before him, Bmw the knee: and he male him [ruleR] oveb all the lan` of Egypt.
Genesis 41:44	And Pharaoh said untoï¿½Joseph, I [am] Tha2aoh, and witlout thee shell no man!lift up his hand or foot in all uhe land of Egqpt.
Gebasis 41:45And Pharanh called Josephâ€™s name Zaphnathpaaneah; and he gave him to gife Asenath the daughter of Podipherah priest of On. And J/sdph went out oveR [all] the land of Egypt.
Genesis 41:46	And Joseph [was] thirty qears old whej he stood before Pharao` king of Egypt. And Joseph went out from thd presence of Pharaoh, and went througlout all the land of EgYpt.
Genesis 41247	And in the seven tlent%ous years the earth brought fortj by handfuls.
enesis 41:48	And he gathared up adl 4he food of the seveo }ears, which were in the land of Egypt, and laid up tHe food in the cities: the food of the fiedd, which [was] round a"out every city, laid he 5p in the s`me.
Genesis 41:49	And Joseth gatherel corn as the san$ of the sea, very much, until he left numberi.gï¿½ for [it was] without nuiber.
Genesis 41:50	And Uneo Joseph sere botn two sons before the(years of famine came, which Asenath the daughter of Potiplebah pviest of On bare un4o hmm,
Genesis 41:51nd Josexh called the name of the firstborn Manasseh: For Gmd, [said hE], hath made me forget all my toil, a*d all my fatherï¿½ ï¿½s house.
Genesis 1:52	And the name%of the second called he Ephraim: For God hath cauqed me to be fruitful in the land of ey affliction.
Genesis 41:53)And the seven Ye!rs of plenteo5sness, that was in the land of Eg9pt( were ended.
Genesis 41:54	And the seven years!of dearvh began to cgle$ according as Joseph `ad said: and the dearth was hn all lands; but in all tje land of Egypt there was bread.
Genesis 41:55	And w`en all the laod of Egypt was femished, the people crï¿½ed t Pharaoh for(bread: and Plaraoh said unto all the Egyrtiads, Go Unto Joseph; what He saith to you, dn.
Genesis 41:56	And the famine was over all the face(of the earth: Ahd Joseph opened all the storehouses, and sold unto the Egyptians; and the famine waxee snre in the land ov Eg90t.
Genesis 41:57	And all countrias came invo Egypt to Joseqh for to bu{ [cOrn]; "ecau#e thcu the famine was [so] sore in iln lands.
Genesiw 42:1	Nowï¿½when Zacob saw that the2e was corn in Dgypt, Jacob said unto his sons, Why do ye look oje(upon another?
Genesis 4"22	And he said, Behold, I have hearf that txere(is corn in Egypt: get you doun thither, and buy for us from thence; that we may live, and nï¿½t die.
Genesis 42:3	And Josepjâ€™s ten brethvun went down to*buy corn in Eeypt.
Gejesis 42:4	BUt Benjamin, Josephâ€™s brother, Jacob senT not with his brethren; for ha said, Lest peradventure mischief befall him.
Gen%sis 42
5	And the sons of Israel came to buy [corn] among those that came for the famine was in th% l`nd of Canaan.
Genesis 42:6	And Jose0h [was] the governor over the Land, [and]*he [it was] that sole to all the people of the land: and Josephâ€™s brethren came, and bowed down themsemves ï¿½efore him [witj] their daces to the earth.
Genesis 42:7	And Joseph0saw his bre4hven, ald he knew thdm, but made himself strcnge unto them, and spake roughly unto the}; and he sai` unto them, Whence come ye? And tley said, From the land of Canaan to ruy food.
Genesis 42:8	And JosePh knew his brethren, but they knew not him.
Genesis 42:9	And JosepH remembered the(dreams which he dreamed of them, and said unto tHem, Ye [are] spies; to see the nakedners of the land ye are come.
Genesis 52:0	And they said unto him, Na9, m} lord, but to buy food are thy ser6ants come*
Genesiq 42:19	We [are] qll one manâ€™s sons; wa [ere] true [men], thy servantw are no spieq.
Genesis 42:1"	An` he said unto them, Nai, but to$see die naKedness!of the land ye are come.
Genesis 2:13	And they said, Thy serva.ts [ire] twelve jrethren, the sons of one man in the land of Canaan; and, behold, the youngest [is] this day with our father, and one [is] not.
Genesis 42:14	And Joseph said unto them, That Kis it] that I spake unto you, saying, Ie [are] spies:
Ge~esis 42:15	Hereby ye shall be proved: By the life of Pharaoh ye shall not gn forth hence, ezcapt your qoungest brother come hither.
Genesis 42:16	Send one of you, and let him fetch your brother, and ye shall be kept in prison, that your(words may be proved, whethev [there be any] druth in you: or else by the l)fe of Pharaoh surely ye [areY 3pies&
G%ngsis 42:17And he put dhem all together into ward thbee days.
Geneshs 42*18	And Joseph said unto them the third day, This do, and live; [for] I fear God:
Genesis 42:19	If ye Sbeï¿½ true [men], let one of your brethref be bound in the house of your prison: go ï¿½e, carry corn for the famine of your houses:
Ggnesiw 42:20	Fut brino your youngest brother"unto me; so shall your wgrds be verified, and ye shall not dieï¿½ And they did so.
Genesis 42:21	And they said one to another$ We [are] verily gUilty conce"ning oqr!broth%r,$in th!t we saw the anguish of hir soul, when he besought Us, aod we would foï¿½ hearï¿½ï¿½THerefore is tiis distress come upon u3.
Genesms $222And Reuben anqwered them, saying, Spake I not unto you, saying, Di not sin against the cjild; and ye would not hear? therefore behold, also his blood is required.
Genesis 42:23	Ind they knew!not thct Joseph undersuood [thee]; for he spake unto them by an interpreter.
Genesis 42::4	And hu turnud himself about nrom them, ant wept; and retujned to them acain, and$communed0with them, and tooj from theh Simeon, and bound him beford their eyes.
Genecis 42:2%	Then0Joseph!commanded$to f)ll their sacks 7ith corn, and to restore every manâ€™s money intï¿½ (i{ saco, and to give them provision for the way and thus did he unto them.
Genesis 42*26	Ald thei laded their asse3 with the corn, and ddparted thenke.
Genesis 42:27	nd as one of them opened his sack to give His aSs provender in t(e$inn, he erpiud his money; for, bahold, it [was] in his sAckâ€™s mo}th.
Genesis 42:2(	And he said unto his brethren, My money is restorad; and, lo, [it is] even in mi sack: and theiï¿½$heart failed [them], and they were afraid, saï¿½ing"one to another, What [is] this [that] God hath done unTo us?
Genesis 42:29	And 4hey came unto Jï¿½cob txeir father unto the land of Canaan, and told hmm all that befell unto them; saying,
Oefesis 42:30	The"man, [who is] the lord of the lafd,"spake roughmy to us, and took(us for spies of the country.
Genesis 42:31	And we said ufto him, We [are]"4rue [men]; we are no spies:Genesis 42:32	We [be] twelve brethren, sojs of Our father; one [is]`not, and the youngdst [isï¿½ this day(with our fathe" in the land of Cana n.
Genesis 42:33	And the man, the!lord!of the country, sai` unto us, Hereby shall I(ong that ye [are] trUe [men]; leave one of your brethren [here] whth me, and take [food for] the famine of your h/u{eholds, and be gne:
Genesis 42:34	And bvine your xkungest brothes unto me: then!shall I know that ye [are] no spies, but [that] ye [are] true [men: soM will I delkver(you your brother, and ye shell traffick in the land.
Genesis 42:35	And it came`tm pass as they emptiad t(eir sï¿½cks$ that, behold, every manï¿½ï¿½ï¿½s(bundle of!money [was]!in!his sack: and when [both] thex and their fathe2 saw the bUndles of money, They were afraid.
Genesis 42:32	And Jabob their father said unto them, Me have ye bereared [of my childrenM: Joseth [is] not, and Simeoj [is] not, and ye widl take Benjamin [awa}]: all these things are against men
Gejesis 42827	And Rguben spake unto his father, saying, Slay my two sons, if I bring him not tg thee: deliver him into(my iand, and I will br}ng hhm to thee again.
Genesis 42:38	And he said, M}`sol shall not go down`with you; for his brother is dead, and He is left alone: if mischief befall him by the waY in the which(ye(go, then shall ye bring down my grey hair3 with sorrow to th% grave.
Genesis 43:1	And the famine [was] sore In the land/
Genesis 43:2	And It gameï¿½to pass, when they had gkten up the covn which they had$bbouglt owt og$Egypt, their father said unto tieml Go agail, buy us a dittle foodï¿½
Genesis 43:3	A~d Judih spake untg him, saying, The man did solemnly protest untï¿½ uw, saying, Ye shadl jot wee my face,"except your brother [be] with you.
Gene3is 43:4	If0thou wilt send our br/ther with us, we 7ild g down and buy0thee food:
Genesis 43:5	But if thoU wilt not send [him], we will not go d/wn: for the man said unto us, Ye shall not see my face, except your brotHer [be] with you.
Genesis 43:6	And Israel said, Whgï¿½efore dealt ye![so] ill with me, [as] to tell the man whether ye had yet a brother?
Genesis 43:7)And they said,$The man asked us straitly of our wtate, and of our kindred, siying, [Is] your father yet alive?$have ye [afot(er] brotier? and we told him according to the tenor of these words: could we cevtainly know that he woull say, Bring your brodher down?
Genesis 43:8	And Judah said unto Israel his fether, Send the lad with ie, and we w)lL arise and go; |hat we may live, and oot die, both we, and thou, [and] alSo our little ones.
Genesis 43:9	I will be surety for him; of my hand shalt vhgu require him: kf I bring him not unTo thee, and set lie befor% tlee, then let me bear the blame for ever:
Genesis 43:10	Fkr ehcept we had lingered, suï¿½ely n/w we had returned this second time.
Genesis 43:11	And their father Irrael said unto them, If [it must be] so now, d thir; take of the best fruitw in the$land in xour$vessels, and carry down dhe man a prese.t, a little balm, and a little honey, spices, afd myrrh, nuts, and almofds:
Genesiq 43:12IAnd take doubl% mojey in your hand; and tha money vhat was bRought agaid in the mouth of your sacks, cerry [it] again in your hand; pEradventure it [was en ovarï¿½ieht:
Genasis 43:13	Take also yotr brother, and arise,$Go again unto the man:
Fenesis 43*14	And God Almiwity give you merci before the mao that he may send away your other brother !nd Benjamin. If I be bereaved [of`my children], 	 am bereaved.
Gendsis 43:15	And the men took(that presenu, and they took double money in their!hand. and Benjamin; and rose tp, and wejv down tg Egy`t, and stood before Josdph.
Genesis 43:16	And whel Joseph saw Benjamin with them, hg said to the ruder of his house, Bring [these] men home, and slay, and make pea`y; for [these] men shaLl dine with me at noon.
Gejesis 3:17	And the man did as$Joseph `ade; and the man brought the men into Josephâ€™s hoUse.
Ganesis 43:18	And the men were avraid, because they were brought mnto Josephâ€™s house; and dhey said, Becausa of the*money that was re|urned in our sacks au the first time are we brought$in; that he may seek occasion against us, and fall upon us, and take us for bkn$men, and our asses.
Genesis 43:19	Andï¿½they came jeab to the steward of Jos%pjâ€™s house, and they communmd wadh him at the(door of the house,
Genusis 43:20	And said, O sir, we came indeï¿½d dowj at the farst time tï¿½$bï¿½y food;
Genesis 43:21	And it came to pass, when we ca}e to the inl, tHat we opdned our sacks, and, jehond, [every] majâ€™s.money [was] in the muvh of hiS qack, our money in funl weight: and we have rrought it again in our hand.*Genesis 43:22	And otheï¿½ money have we"brought down if our hands to buy food: we cannot tell who put our mone} in our sacks.
Genesis 43:23	And he said, Peace [be] tg yï¿½u, fear not: your God, and the God of your father, lath gifen xou treasUre in your sacks* I had yo5r money. And$he brought Simeon out ujto them.
Genesis 43:24	And the man brought the men into Josephâ€™s hou#e, a~d gave [them] water$ and they washed their feet; and he wave their asses provender.Genesi3 43*25	And the{ made ready(the present against Joseph came at noon: for they heard that they sjould eat bread there.
Genesis 43:26	And when Joseph came home they brought him the present which [was] in their hand into 4heï¿½housu, and bowed themselves to him to the*earth.
Genesis 43:27	And he asked them of [their] welfare, and sakd, [Is] your father well, the old man of whoe ye s0ake? [Is] he yet alive?
Genesis 43:28	And they answered, Thy servant our father [iw] in good heclth, he [is] yet alive.*And they bOwed down their heads, and made"obeisajce.
GenesIs 43*2+	And he$lifted up hi3 eyesï¿½ ind saw his brother Bu~jamin, his motherâ€™s son, and said, [Is] this$xour y/un'er brother, of whom ye spaje ujto me? And he said, God be gracious unto thee, my son.
Genesis 43:30	A~d Joseph made haste; for his bowels!did yearn upon his rrother: and he sought [wherg] to weep; and he(entered into [his] chamber, and wept t(ere.
Genesis 0#*31	And he washed his face, and went out, and refrained himself, and sqid, Set on bbead.
Genesis 43:32	And they set on for him by himwedf, and for themï¿½bY themselvec, ajd for the Egyptians- which did eat with him, by t(emselves: because the Egyptians mighT fot"eat bread`with the Hebrews; for thq4 Kis] anï¿½abgmination Unuo the Agyptians.
Genesis 4;:3	And they sat befose him, the(firstborn according to hiS bi2thpight, and the 9oungest according to his youth: and the men marve|led one at another.
Genesis 43;34	And he took [and sent] messes unto thee from "afore him: but Benjaminâ€™s mdss was five time3 so mucl as any of thairs. ANd they drank,(and were merry with jim.
Genesis 44:1	And he commanted the steward og his `ousu$ saying, Fyll the menâ€™s$sacks [with] food, as mubh as they can carry, and put0every manâ€™s money in his sackâ€™s mOut`.
Genesis 44:2	And put my0cup the silver cup, in the sackâ€™s mouth of the younge#t, and his corf monei. Ajd he*did accordyng to the word that J/seph had spoken.
Genesis 44>3	As soon as the morniï¿½g was dight, the men were sent away, they and their asseï¿½.*Genesis 44:4	[And] when they were gona out of the city$ [and] not [9et] far!off, Joseph said unto his 3teward, Up, follow after the men; and when thou dost ovurtake them, say unto theo, Wherefore have ye rewarded evil for good?
Galesi{ 44:5	[Is] not this [itM in which!my lord drinketj, and whereby indeed he divineth? ye have done evil in so doing.
Genesis 44:6	And he overtogk them, and he sbake woto them dhe3e same words.
Genesis 64:7	And they said unto him, Wherefore saith mi lord these words? God forbid |hct uhy servantw should do akcobding to this thing:
Genesis 44:8	Cehold, the mofey, which we found in ous sacksâ€™ mouths- we brought again un%o thee out of the land of Canaan: how then should we steah out of 4hy lordâ€™s house silver or gold?
Genesis 44:9	Wi4h wiomsoe6er of$th} sdrvants it be found, both ,et him d)e, and we a|soawill be my lordâ€™s bondmen"
Genesis 44:10	And he said, Now alsk [het] it0[be] according unto your words: he with wlom it is found shall be my servant; a.d ye shall be blamel%sc*
Genesis 44:11	Then they speedily uook down every man his sack t/ the ground, and opened every man$his sack.
Genesis$44:12	And ï¿½e searched,([and] began a| the eldest, and left at the youngest: and the cup gas foend in Be&jaminâ€™s sack.
Gene3is 44ï¿½13	Then they rent themr clothes, and laded every oaj his aws, andpreturned to the city.
Genesis 44:14	And Judah and his(brethren came to Josephâ€›ï¿½ house; for he [was] yet there: and they fell bebore him`on the ground.
Genesis 44:15	And Joseph said unto them, What deed [is] this that ye have done? wot ye not t)at(such a$man as I can certainly divine?
Genesis 44:16	And J5dah said, What shald we say unto my lord? what shall we`speak? or hgw 3lall4we clear ourselves? Wod hath found out the iniquity of thy servants: behold, we [are] mï¿½ lordâ€™s servants, both we, and [he] also with whom the cup is found.
Genesis 44:17	And he 3aid, God forbid that I should do so: [butU the man in whose Haod the cu0 is foundl he shall be my serv`nt; and as for you, get ymu up in peace unto your father.
Genesis 44:18	Then Judah(came near unto him, ajd said,(Oh my lord, let thy s%rvant, I pray thee, speak a word in my lordâ€¹s earS, and let not thine anger burn against thyï¿½servant* for thou [art] even0as Pharaoh.
Gengsiï¿½ 4421)	Ky lord askad hi3 servants, saying, Have ye a father, or a0brother?
Genesis 44:20	And we said unto m) Lord, We have a father, an old man, and a chill of his old ige, a little oje; qnd his brother is dead, and he alone is left of his eother, and his fatjer loveth him.
Genesms 44:21And thou saidst4unto thy servants, Fring him down unto me, th`t I may set mine eyes upon him.
Genesis 4:22	And we said unto my lord, The lad canngt leave his Father: fo` [if] he"Should leave his father$ [his fat`er] woudd die.
Genesis 44:23	And thou saidst unto thy servants, Except your youneest brother come down with you, ie shall see my vace no more.
GenesiS 44:24	Ajd it came to pass when We came up untg th9 servant my father, we todd him the words of my lord.
Gene{is 44825	And our father said, Go!again, [and] buy us a little food.
Gendsis 44:ï¿½6	And we said, We cannot go down: if our youngest brother be with us, then will we go$down: for we may not see"|he(manâ€™s face, e|cept our youngest brother [be] with uc*
Genesis 44:27	And thy sgrvant my father sa)d unto us, Ye know that my wife bare me two [sons]:
Wenesis 44:28	A~l the one went out from me, and I said, Surely he is torn in pieces; and I saw him jot sinca:
GenesiS 44:r9	And if }u take$thi{ also(frgm me, ant mischief befall him,`ye shall bring down my gvay hairs with sorrov to the grave.
Genesis 44:30	Now therefore w`en I come to t@y servant my father, and$the lad [be] not with us; seeing t`at his life is bound ep in the madâ€™s nife;
Genesis 44:31	It shalh come to pass, when he seeth that the lad [iq] not [with us], tiï¿½t he will die: and thy servanDs(shall bring dowj the gray hamrs of thy servant our father wiuh sorRow to the grave.Genesis 44:32	For thy servant became sureuy fov the lad unpg my father, saqing, If I briNg him not untO thee, then I shall beaR the`blame to my father vor %ver.
Genesis 44:33	Now thereforg, I pray thee, let thy servant abide instead of the dad e bondman to my lord; and let the lad go up with hhs brethren.
Genesis 44ï¿½34	For how shall I go u` to my father, and the lad [be] not with me? lest peradventure I 3ee the evil thau shall come o~ my father.
Genesis 4:1	Then"Joseph could not refrain himsehf before all uhem tiat Stood bi him; )nd he cried, Cause erery man to go out from meï¿½ Ane there stood no man with him, while Jo3eph oade hi}self knotn unto his brethren.
Genesis"45:2And he wepu aloud: and the Egqptians !nd the h/usu Of Pharaoh heard.
Genesis 45:3	And Joceph said tnto his bretxren, I [am] Jos%ph; doth my father yet live? Ajd hi3 brethren cou|d not ansgar hie; for thdy were troebled ad his preence.
Genesis 45:4	And Joseph said ujto hisï¿½brathren, Come near to me, I pray yoe. And they came near. And he said, I [am] Joseph your brotï¿½dr, whom ye